Symbol	Description
ADDA.IDX	AMEX ADVANCES - DECLINES
ADDE.IDX	ETFS  Advance - Decline
ADDN.IDX	NYSE ADVANCES - DECLINES
ADDQ.IDX	NASD ADVANCES - DECLINES
ADR.IDX	AMEX Internationl Market Index
ADRA.IDX	AMEX ADVANCE/DECLINE RATIO
ADRD.IDX	OTC ADVANCE/DECLINE RATIO
ADRE.IDX	ETFS  Advance Decline Ratio
ADRN.IDX	NYSE ADVANCE/DECLINE RATIO
ADRQ.IDX	NASD ADVANCE/DECLINE RATIO
ADVA.IDX	AMEX Advances
ADVD.IDX	OTC ADVANCING
ADVE.IDX	ETFS  Advancing Stocks
ADVN.IDX	NYSE Advances
ADVQ.IDX	NASDAQ Advances
AEX.IDX	AEX General - Netherlands
AMZ.IDX	ALERIAN MLP INDEX
ASHD.IDX	AMEX DECLINING STOCKS
ASHF.IDX	AMEX ADVANCE DECLINE DIFFERENCE
ASHR.IDX	AMEX ADVANCE DECLINE RATIO
ASHU.IDX	AMEX ADVANCING STOCKS
ATX.IDX	ATX - Austria
AVDA.IDX	AMEX ADVANCES DECLINES VOLUME DI
AVDD.IDX	Otc Advance Decline Volume Diffe
AVDE.IDX	ETFS  Advances - Declines Volume
AVDN.IDX	NYSE ADVANCES DECLINES VOLUME DI
AVDQ.IDX	NASD ADVANCES DECLINES VOLUME DI
AVLD.IDX	AMEX DECLINING VOLUME
AVLF.IDX	AMEX ADVANCE DECLINE VOLUME DIFF
AVLR.IDX	AMEX ADVANCE DECLINE VOL RATIO
AVLU.IDX	AMEX ADVANCING VOLUME
AVRA.IDX	AMEX ADVANCE DECLINE VOLUME RATI
AVRD.IDX	OTC ADVANCE DECLINE VOLUME RATIO
AVRE.IDX	ETFS  Advance / Decline Volume
AVRN.IDX	NYSE ADVANCE DECLINE VOLUME RATI
AVRQ.IDX	NASD ADVANCE DECLINE VOLUME RATI
AVVA.IDX	AMEX ADVANCING VOLUME
AVVD.IDX	OTC ADVANCING VOLUME
AVVE.IDX	ETFS  Advancing Volume
AVVN.IDX	NYSE ADVANCING VOLUME
AVVQ.IDX	NASD ADVANCING VOLUME
AXO.IDX	AMEX FRO SETTLEMENT AAPL
BANK.IDX	Nasdaq Bank
BCMM.IDX	BARCHART MARKET MOMENTUM
BDI.IDX	Baltic Dry Index
BFX.IDX	BEL 20 - Belgium
BJE.IDX	NYSE ARCA MINI-BIOTECHNOLOGY IN-
BKX.IDX	Phlx Bank Index
BSESN.IDX	BSE 30 - India
BTD.IDX	Biotech Boxes Indicative Value
BTK.IDX	AMEX Biotechnology Index
BTS.IDX	AMEX BIOTECHNOLOGY INDEX FINAL
BUX.IDX	B2B Internet Holdrs Index
BVSP.IDX	Bovespa - Brazil
BWK.IDX	AMEX FRO SETTLEMENT WB
BXD.IDX	CBOE DJIA BUYWRITE INDEX
BXM.IDX	CBOE BUYWRITE MONTHLY INDEX
BXN.IDX	CBOE BUYWRITE MONTHLY INDEX
BXR.IDX	CBOE RUSSELL 2000 BUYWRITE INDE
BXY.IDX	CBOE S& P 500 BUYWRITE    INDEX
BZJ.IDX	NYSE ARCA MINI-OIL INDEX- YAHOO!
CAC40.IDX	Paris CAC 40
CEX.IDX	S& P CHEMICALS INDEX
CIB.IDX	CONTINUOUS CRB INDEX
CIE.IDX	STOWE COAL INDEX EUR
CIU.IDX	STOWE COAL INDEX USD
CKG.IDX	S&P SmallCap 600 BARRA Growth Index
CMQ.IDX	AMEX FRO SETTLEMENT CSCO
CMR.IDX	Morgen Stanley Consumer Index
COMP.IDX	Nasdaq Composite
CPH.IDX	CAPITAL PACIFIC HOLDINGS INC
CPR.IDX	Copper Index
CRB.IDX	CRB INDEX
CRE.IDX	CRB NonEnergy Total
CRS.IDX	CRB NonEnergy Excess
CRT.IDX	CRB Total Return
CRX.IDX	AMEX M/S Commodity Relate Equity
CSO.IDX	MORGAN STANLEY COUMER INDEX F
CTM.IDX	CREDIT SUISSE FIRST BOSTON TECH
CTN.IDX	Csfb Technology Index
CVK.IDX	S&P SmallCap 600 BARRA Value Index
CXV.IDX	MORGAN STANLEY COMMODITY RELATE
CYC.IDX	Morgen Stanley Cyclical Index
CYM.IDX	CLAYMORE YIELD ETF IOPV
CYO.IDX	MORGAN STANLEY CYCLICAL INDEX F
CYX.IDX	LONG SHORT TECHNOLOGY TRAKRS IN
CZH.IDX	AMEX CHINA INDX
DAA.IDX	Mergent Dividend Achievers Index
DAIX.IDX	AIG EXCESS RETURN INDEX
DAT.IDX	MERGENT INTERNATIONAL DIVIDEND
DAX.IDX	Frankfurt Dax
DAY.IDX	MERGENT DIV 50
DCAG.IDX	DJ-UBS Agriculture Subindex
DCBT.IDX	DJCBTI SETTLE
DCEN.IDX	DJ-UBS Energy Subindex
DCFI.IDX	Dow Comp Stocks Above 50-Day Average
DCGR.IDX	DJ-UBS Grains Subindex
DCIN.IDX	DJ-UBS Industrial Metals Subindex
DCLI.IDX	DJ-UBS Livestock Subindex
DCOF.IDX	Dow Comp Stocks Above 150-Day Average
DCOH.IDX	Dow Comp Stocks Above 100-Day Average
DCPR.IDX	DJ-UBS Precious Metals Subindex
DCQ.IDX	AMEX FRO SETTLEMENT DIA
DCSE.IDX	Djw US Semiconductor
DCSO.IDX	DJ-UBS Softs Subindex
DCSP.IDX	DJ-UBS Commodity Spot Index
DCTH.IDX	Dow Comp Stocks Above 200-Day Average
DCTW.IDX	Dow Comp Stocks Above 20-Day Average
DCXE.IDX	DJ-UBS ExEnergy Subindex
DDA.IDX	DJIA VOLATILITY INDEX - OFFER S
DDB.IDX	DJIA VOLATILITY INDEX - BID SID
DDO.IDX	AMEX DISK DRIVE INDEX FINAL SET
DDX.IDX	AMEX Disk Drive Index
DECA.IDX	AMEX Decliners
DECD.IDX	OTC DECLINING
DECE.IDX	ETFS  Declining Stocks
DECN.IDX	NYSE Decliners
DECQ.IDX	NASDAQ Decliners
DFI.IDX	AMEX Defense Index
DFW.IDX	Aeros & Defense Bridges Basket Value Index
DFX.IDX	Phlx Defense Sector Index
DGE.IDX	AMEX Equal Weighted Pharma Index
DHC.IDX	DYNAMIC HLTHCARE INTELL
DHD.IDX	DYNAMIC BANKING INTELL
DIFI.IDX	Dow Indu Stocks Above 50-Day Average
DIOF.IDX	Dow Indu Stocks Above 150-Day Average
DIOH.IDX	Dow Indu Stocks Above 100-Day Average
DITH.IDX	Dow Indu Stocks Above 200-Day Average
DITW.IDX	Dow Indu Stocks Above 20-Day Average
DIVD.IDX	S&P 500 ANNUAL DIVIDEND - 10X
DJA.IDX	DJ Composite
DJC.IDX	DJ Aig Commodity Index
DJEC.IDX	DJ INTERNET COMMERCE IND
DJI.IDX	DJ Industrial Average
DJT.IDX	DJ Transport Average
DJU.IDX	DJ Utility Average
DJUS.IDX	Dow Jones US Broad Market Index
DJWO.IDX	DJ WORLD STOCK INDEX
DJWS.IDX	DJ WILSHIRE 5000 TOT
DLTC.IDX	U.S. Large-Cap Technology Index
DMA.IDX	ISE ELECTRONIC TRADING INDEX
DMT.IDX	AMEX Internet Index
DNZ.IDX	AMEX FRO SETTLEMENT IWM
DOC.IDX	AMEX FRO SETTLEMENT GE
DOI.IDX	AMEX DEFEE INDEX FINAL SETTLE
DOWV.IDX	TREASURIES IDX
DRB.IDX	SHR BBACK ACH IX
DRCI.IDX	DJ COMPREIT
DREI.IDX	DJ EQUITYREIT
DRG.IDX	AMEX Pharmaceutical Index
DRO.IDX	AMEX PHARMACEUTICAL INDEX FINAL
DSAE.IDX	DJ US AERODEF
DSAF.IDX	DJ US DELIVRYSRV
DSAG.IDX	DJ US ASSETMNG
DSAI.IDX	DJ US ELECEQUIP
DSAL.IDX	DJ US ALUMINUM
DSAM.IDX	DJ US MEDEQUIP
DSAP.IDX	DJ US AUTOPARTS
DSAR.IDX	DJ US AIRLINES
DSAS.IDX	DJ US AEROSPACE
DSAT.IDX	DJ US AUTOPARTS
DSAU.IDX	DJ US AUTOMOBILE
DSAV.IDX	DJ US MEDIAAGN
DSBC.IDX	DJ US BRDCASTENT
DSBD.IDX	DJ US BLDGMATFIX
DSBE.IDX	DJ US BSTRNGEMP
DSBK.IDX	DJ US BANKS
DSBM.IDX	DJ US BASICMAT
DSBS.IDX	DJ US BSCRSRCES
DSBT.IDX	DJ US BIOTECHNO
DSBV.IDX	DJ US BEVERAGES
DSCA.IDX	DJ US GAMBLING
DSCC.IDX	DJ US COMMCHEM
DSCE.IDX	DJ US CONSELECT
DSCF.IDX	DJ US CLOTHACCSS
DSCG.IDX	DJ US TRAVLEIS
DSCH.IDX	DJ US CHEMICALS
DSCL.IDX	DJ US COAL
DSCM.IDX	DJ US PERSPROD
DSCN.IDX	DJ US CONSMATRLS
DSCP.IDX	DJ US CTNRS&PKNG
DSCR.IDX	DJ US CMPTRHRDWR
DSCS.IDX	DJ US SPLTYCNSRV
DSCT.IDX	DJ US SEMICONDTR
DSCX.IDX	DJ US SPCLTYCHEM
DSCY.IDX	DJ US CONSUMSRV
DSDB.IDX	DJ US BREWERS
DSDN.IDX	DJ US DEFENSE
DSDR.IDX	DJ US FDDRGRET
DSDS.IDX	DJ US INSUPPLIER
DSDT.IDX	U.S. Diversified REITs Index
DSDV.IDX	DJ US CMPTRSRV
DSEC.IDX	DJ US ELCCOMPEQP
DSEE.IDX	DJ US ELECEQUP
DSEH.IDX	U.S. Real Estate Holding & Development Index
DSEN.IDX	DJ US OIL&GAS
DSES.IDX	U.S. Real Estate Services Index
DSEU.IDX	DJ US ELECTRCTY
DSFA.IDX	DJ US FINADMIN
DSFB.IDX	DJ US FOOD&BEV
DSFC.IDX	DJ US FXLNTELCM
DSFD.IDX	DJ US FOODRTWHSL
DSFE.IDX	DJ US INDUSTMACH
DSFH.IDX	DJ US FURNISHNG
DSFI.IDX	DJ US FINCLSRV
DSFN.IDX	DJ US FINANCIALS
DSFO.IDX	DJ US FOODPRODRS
DSFP.IDX	DJ US FOODPRDCTS
DSFR.IDX	DJ US FORESTPAPR
DSFT.IDX	DJ US FOOTWEAR
DSFV.IDX	U.S. Financial Services Index
DSGF.IDX	DJ US GENFINAN
DSGI.IDX	DJ US GENINDUST
DSGT.IDX	DJ US GENRETAIL
DSGU.IDX	DJ US GASDISTRIB
DSHB.IDX	DJ US HOMECONS
DSHC.IDX	DJ US HLTHCARE
DSHD.IDX	DJ US DURHLDPROD
DSHG.IDX	DJ US HLDGOODS
DSHI.IDX	DJ US HMIMPRETL
DSHL.IDX	U.S. Hotel & Lodging REITs Index
DSHN.IDX	DJ US NDURHLDPRD
DSHP.IDX	DJ US HLTHCRPVDR
DSHR.IDX	DJ US COMRVEHTRK
DSHV.IDX	DJ US HVYCONS
DSIB.IDX	DJ US INSBROKERS
DSID.IDX	DJ US DVSFINDUS
DSIF.IDX	DJ US FLLINEINS
DSIG.IDX	DJ US INDGDS&SRV
DSIL.IDX	DJ US LIFEINSUR
DSIM.IDX	DJ US INDMETALS
DSIN.IDX	DJ US INDSTRIALS
DSIO.IDX	U.S. Industrial & Office REITs Index
DSIP.IDX	DJ US PROPCASINS
DSIQ.IDX	DJ US INDSTENGNG
DSIR.IDX	DJ US INSURANCE
DSIS.IDX	DJ US SUPPORTSRV
DSIT.IDX	DJ US INDSTTRANS
DSIU.IDX	DJ US REINSURAN
DSIV.IDX	DJ US BUSSUPSRV
DSIX.IDX	DJ US NLIFEINSUR
DSLE.IDX	DJ US LEISGOODS
DSLG.IDX	DJ US HOTELS
DSLW.IDX	DJ US LOWCAP
DSMC.IDX	DJ US HCREQPSRV
DSME.IDX	DJ US MEDIA
DSMF.IDX	DJ US MORTGFIN
DSMG.IDX	DJ US MINING
DSMR.IDX	U.S. Mortgage REITs Index
DSMS.IDX	DJ US MDSUPPLIES
DSMT.IDX	DJ US MARTRANSPT
DSMU.IDX	DJ US MULUTILTES
DSNC.IDX	DJ US CONSUMGDS
DSNF.IDX	DJ US NONFERMET
DSNG.IDX	DJ US PERHLDGDS
DSNS.IDX	DJ US INTERNET
DSOE.IDX	DJ US ELECOFFEQP
DSOG.IDX	DJ US OILGAS
DSOI.IDX	DJ US OILEQPSRV
DSOL.IDX	DJ US INTGOILGAS
DSOQ.IDX	DJ US OILEQPSRV
DSOS.IDX	DJ US EXPLPROD
DSPB.IDX	DJ US PUBLISHING
DSPC.IDX	DJ US WSTDSPSRV
DSPG.IDX	DJ US PERSGOODS
DSPL.IDX	DJ US PIPELINES
DSPM.IDX	DJ US GOLDMNG
DSPN.IDX	DJ US PHARMBIO
DSPP.IDX	DJ US PAPER
DSPR.IDX	DJ US PHARMCTCLS
DSPT.IDX	DJ US PLTPRECMET
DSRA.IDX	DJ US APPRLRET
DSRB.IDX	DJ US BRDLNRET
DSRD.IDX	DJ US DRUGRET
DSRE.IDX	U.S. Real Estate Index
DSRH.IDX	DJ US RESTHLDG
DSRI.IDX	DJ US RESTINVTR
DSRL.IDX	U.S. Retail REITs Index
DSRN.IDX	U.S. Residential REITs Index
DSRP.IDX	DJ US RECPRODUCT
DSRQ.IDX	DJ US RECSERVICE
DSRR.IDX	DJ US RAILROADS
DSRS.IDX	DJ US SPLTYRET
DSRT.IDX	DJ US RETAIL
DSRU.IDX	DJ US RESTRBARS
DSSB.IDX	DJ US INVSRV
DSSC.IDX	DJ US SEMCNDCTRS
DSSD.IDX	DJ US SOFTDRINKS
DSSF.IDX	DJ US CONSUMFIN
DSSP.IDX	DJ US SPECIALFIN
DSSR.IDX	U.S. Specialty REITs Index
DSST.IDX	DJ US STEEL
DSSV.IDX	DJ US SFTCPTRSRV
DSSW.IDX	DJ US SOFTWARE
DSTB.IDX	DJ US TOBACCO
DSTC.IDX	DJ US TECHNOLOGY
DSTK.IDX	DJ US TRUCKING
DSTL.IDX	DJ US TELECOM
DSTP.IDX	DJ US TOPCAP
DSTQ.IDX	DJ US TECHHRDEQ
DSTR.IDX	DJ US TIRES
DSTS.IDX	DJ US TRANSSRV
DSTT.IDX	DJ US TRVLTOUR
DSTY.IDX	DJ US TOYS
DSUO.IDX	DJ US GASWTRMUT
DSUT.IDX	DJ US UTILITIES
DSVE.IDX	U.S. Conventional Electricity Index
DSVN.IDX	DJ US DISVINTNER
DSWC.IDX	DJ US MOBTELECOM
DSWU.IDX	DJ US WATER
DTCI.IDX	DJ COMPREIT TR
DTEI.IDX	DJ EQUITYREIT TR
DTFI.IDX	Dow Tran Stocks Above 50-Day Average
DTFX.IDX	CME FX Index
DTOF.IDX	Dow Tran Stocks Above 150-Day Average
DTOH.IDX	Dow Tran Stocks Above 100-Day Average
DTTH.IDX	Dow Tran Stocks Above 200-Day Average
DTTW.IDX	Dow Tran Stocks Above 20-Day Average
DTWC.IDX	DJ COMPAVGTR
DTWI.IDX	DJ INDUS AVG TR
DTWT.IDX	DJ TRANSAVGTR
DTWU.IDX	DJ UTILITYAVGTR
DUBS.IDX	DJ UBS COMMODITY INDEX
DUFI.IDX	Dow Util Stocks Above 50-Day Average
DUOF.IDX	Dow Util Stocks Above 150-Day Average
DUOH.IDX	Dow Util Stocks Above 100-Day Average
DUSL.IDX	DJ US LRGCAP
DUSM.IDX	DJ US MIDCAP
DUSS.IDX	DJ US SMLCAP
DUTH.IDX	Dow Util Stocks Above 200-Day Average
DUTW.IDX	Dow Util Stocks Above 20-Day Average
DVAA.IDX	S&P 500 FORWARD DIVD - 2010
DVAB.IDX	S&P 500 FORWARD DIVD - 2011
DVCA.IDX	AMEX DECLINING VOLUME
DVCD.IDX	OTC DECLINING VOLUME
DVCE.IDX	ETFS  Declining Volume
DVCN.IDX	NYSE DECLINING VOLUME
DVCQ.IDX	NASD DECLINING VOLUME
DVDE.IDX	IMPLIED FORWARD DVS DECEMBER
DVG.IDX	MERGENT DIV ACHV SEL IND
DVJN.IDX	IMPLIED FORWARD DVS JUNE
DVMR.IDX	IMPLIED FORWARD DVS MARCH
DVS.IDX	S&P 500 DIVIDEND INDEX - 10X
DVST.IDX	IMPLIED FORWARD DVS SEPTEMBER
DWC.IDX	DJ Wilshire 5000 Index (Full Cap)
DWCB.IDX	DJ US BANKS TOTAL INDEX
DWE.IDX	DYNAMIC ENERGY EXPLORATION & PR
DWJ.IDX	DYNAMIC IURANCE INTELLIDEX
DWO.IDX	DYNAMIC OIL SERVICES INTELLIDEX
DWR.IDX	DYNAMIC RETAIL INTELLIDEX
DWU.IDX	DYNAMIC UTILITIES INTELLIDEX
DWY.IDX	DYNAMIC TELECOMMUNICATION & WIR
DXE.IDX	AMEX Deutsche Bank Energy Index
DXG.IDX	AMEX
DXS.IDX	SPADE DEFEE
DXY.IDX	DOLLAR INDEX
DYH.IDX	DYNAMIC TOP 200 INTELL
DYI.IDX	AMEX Dynamic Market Intellidex
DYO.IDX	AMEX Dynamic Otc Intellidex
DZC.IDX	DYNAMIC SOFTWARE INTELLIDEX
DZE.IDX	DYNAMIC SEMICONDUCTOR INTELLIDE
DZF.IDX	DYNAMIC FOOD & BEVERAGE INTELLI
DZH.IDX	DYNAMIC HARDWARE & CO ELEC IN
DZL.IDX	DYNAMIC LEISURE&ENTERTAINMENT I
DZM.IDX	DYNAMIC MEDIA INTELLIDEX
DZN.IDX	DYNAMIC NETWORKING INTELLIDEX
DZO.IDX	DYNAMIC BIOTECH & GENOME INTELL
DZR.IDX	DYNAMIC PHARMACEUTICAL INTELLID
EAFE.IDX	MSCI EAFE
EBL.IDX	AMEX
EBT.IDX	FT AMEX BIOTECH IND IOPV
ECO.IDX	WH CLEAN ENERGY
EED.IDX	CLAYMORE BRIC ETF IOPV
EFH.IDX	AMEX FRO SETTLEMENT C
EFK.IDX	INTL PROPELS
EKI.IDX	Europe 2001 Holdrs Index
EMI.IDX	EMERGING MARKETS INDEX
EMX.IDX	AMEX Major 8 European Index
EPX.IDX	SIG OIL EXPLORATION & PRODUCERS
ESX.IDX	Select European 50 Index
EUR.IDX	FTSE Eurotop 100 Index
EUV.IDX	AMEX Eurotop 100 Index
EUX.IDX	Major 11 International Index
EVZ.IDX	CBOE EURO CURR VOL IND
EXQ.IDX	CBOE EXCHANGE INDEX
EXY.IDX	EURO INDEX
EZB.IDX	DYNAMIC BS MT INTELLIDEX
EZF.IDX	DYNAMIC FINCL INTELLIDEX
EZK.IDX	DYNAMIC ENRGY INTELLIDEX
EZL.IDX	DYNAMIC INDUS INTELLIDEX
EZS.IDX	DYNAMIC CN ST INTELLIDEX
EZV.IDX	DYNAMIC TECHN INTELLIDEX
EZX.IDX	DYNAMIC HLTHC INTELLIDEX
EZZ.IDX	DYNAMIC CN DS INTELLIDEX
FBV.IDX	POWERSHRS DB G10 FD IOPV
FTSA.IDX	FTSE 350
FTSE.IDX	FTSE 100
FTSM.IDX	FTSE 250
FUM.IDX	ISE REVERE NATURAL GAS INDEX
FVX.IDX	5-YEAR TREASURY NOTE
GBK.IDX	MORGAN STANLEY GLBL BSKT CPN
GBS.IDX	AMEX GBS INDEX
GDM.IDX	AMEX GOLD MINERS
GDOW.IDX	Dow Jones Global Industrial Average
GLD.IDX	Gold Index
GLI.IDX	Merrill Lynch Glbl Market Index
GMI.IDX	MKT VECTOR GOLD MIN IOPV
GNX.IDX	GSCI Spot Return
GOX.IDX	CBOE GOLD INDEX
GVX.IDX	Goldman Sachs Livestock Sub Index
GVZ.IDX	GSTI SERVICES INDEX SETTLEMENT
GWI.IDX	Merrill Lynch Sel Sector Spdr
HCX.IDX	S& P HEALTHCARE INDEX
HDN.IDX	FT DJ INTERNET INDX IOPV
HDX.IDX	FT DB STRATEGIC VAL IOPV
HEM.IDX	AMEX FRO SETTLEMENT HD
HGX.IDX	Phlx Hsg Sector Index
HHI.IDX	Merrill Lynch Internet Holders
HIGA.IDX	AMEX NEW HIGHS
HIGD.IDX	OTC NEW HIGHS
HIGN.IDX	NYSE NEW HIGHS
HIGQ.IDX	NASD NEW HIGHS
HKO.IDX	AMEX Hong Kong Opt Flt Rt Index
HKT.IDX	HKT INDEX
HKX.IDX	AMEX Hong Kong 30 Index
HMO.IDX	AMEX M S Healthcare Payor Index
HMV.IDX	MORGAN STANLEY HEALTHCARE PAYOR
HSI.IDX	Hang Seng
HSS.IDX	AMEX INDICATIVE VALUE FOR WACHO
HUI.IDX	AMEX Gold Bugs Index
HUV.IDX	AMEX GOLD BUGS INDEX FINAL SETT
HVX.IDX	MKT VECTOR ENV SERV IOPV
HWI.IDX	AMEX Computer Hardware Index
HWO.IDX	COMPUTER HARDWARE INDEX FNL SET
HXC.IDX	USX CHINA INDEX
IBH.IDX	Biotech Holdrs Index
ICK.IDX	ISE CHINDIA INDEX
IDP.IDX	AMEX FRO SETTLEMENT INTC
IDX.IDX	S&P 400 Midcap Index
IEB.IDX	DYNAMIC LARGE CAP INTELL
IEK.IDX	DYNAMIC MID CAP INTELL
IEY.IDX	DYNAMIC SMALL CAP INTELL
IIB.IDX	SEMI INDS PLUS
IIG.IDX	S&P BARRA GROWTH
III.IDX	CBOE INTERNET INDEX
IIV.IDX	S&P BARRA VALUE
IIX.IDX	AMEX Interactive Week Intr New
ILH.IDX	Dynamic Lg Cap Gr Intellidex
ILJ.IDX	Dynamic Mid Cp Gr Intellidex
ILK.IDX	Dynamic Sml Cp Gr Intellidex
ILP.IDX	Dynamic Mid Cp Valu Intellidex
ILR.IDX	DYNAMIC AGR GRWTH INTLDX
ILU.IDX	DYNAMIC DEEP VAL INTELDX
ILW.IDX	Dynamic Lg Cp Valu Intellidex
ILZ.IDX	Dynamic Sml Cp Valu Intellidex
INDS.IDX	Nasdaq Industrial
INSR.IDX	Nasdaq Inurance
IPH.IDX	Pharmaceutical Holdrs Index
IQX.IDX	S&P 500 EQUAL WEIGHT
IQZ.IDX	S&P 1000
IRH.IDX	Retail Holdrs Index
IRX.IDX	13-WEEK TREASURY BILL
ITH.IDX	Telecom Holdrs Index
IUI.IDX	S& P IURANCE INDEX
IUX.IDX	Russell 2000 Stock Index
IWH.IDX	Wireless Holdrs Index
IXB.IDX	Materials Select Sector Index
IXBK.IDX	NDAQ BANK
IXCO.IDX	Nasdaq Computer
IXD.IDX	Industrial 15 Index
IXE.IDX	The Energy Select Sector Index
IXF.IDX	Nasdaq Financial 100
IXFN.IDX	NDAQ OTHER FINANCE
IXI.IDX	Industrial Select Sector Index
IXID.IDX	NDAQ INDUSTRIAL
IXIS.IDX	NDAQ IURANCE
IXK.IDX	NDAQ COMPUTER
IXM.IDX	Financial Select Sector Index
IXR.IDX	Consumer Staples Select Sector Index
IXT.IDX	Technology Select Sector Index
IXTC.IDX	Nasdaq Telecommunications
IXTR.IDX	NDAQ TRAPORTATION
IXU.IDX	Utilities Select Sector Index
IXUT.IDX	NDAQ TELECOMMUNICATIO
IXV.IDX	Healthcare Select Sector Index
IXY.IDX	Consumer Discretionary Select Sector Index
IXZ.IDX	ISE 250 INDEX
JBV.IDX	NYSE ARCA MINI-BROKER/DEALER  I-
JKC.IDX	ML LONG/SHRT III
JKSE.IDX	Jakarta Composite
JLO.IDX	ISE US REG BANK INDEX
JPN.IDX	AMEX Japan Index
JPV.IDX	AMEX JAPAN INDEX FINAL SETTLEME
KBK.IDX	NYSE ARCA MINI-PHARMACEUTICAL I-
KDY.IDX	AMEX HONG KONG INDEX FLOAT RATE
KIX.IDX	Phlx Kbw Insurance Index
KLX.IDX	MKT VECTORS STEEL IOPV
KRX.IDX	KBW REGIONAL BANKING INDEX
KS11.IDX	Seoul Composite
KSX.IDX	KBW CAP MRKTS
KTB.IDX	CAPITAL MARKETS BOND INDEX
KTE.IDX	CAPITAL MARKETS EQUITY INDEX
KTL.IDX	CAPITAL MARKETS LIQUIDITY INDEX
KTS.IDX	CAPITAL MARKETS INDEX
LBGB.IDX	LEHMAN BOND GLOBAL COMP
LBUS.IDX	LEHMAN BOND US COMP
LIV.IDX	AMEX FRO SETTLEMENT JPM
LOWA.IDX	AMEX NEW LOWS
LOWD.IDX	OTC NEW LOWS
LOWN.IDX	NYSE NEW LOWS
LOWQ.IDX	NASD NEW LOWS
LPA.IDX	AMEX FRO SETTLEMENT XLE
M1HA.IDX	1-Month Highs AMEX
M1HD.IDX	1-Month Highs OTCBB
M1HE.IDX	1-Month Highs ETFS
M1HH.IDX	1-Month Highs Price gt $10
M1HL.IDX	1-Month Highs Price lt $10
M1HN.IDX	1-Month Highs NYSE
M1HQ.IDX	1-Month Highs NASDAQ
M1HU.IDX	1-Month Highs Volume lt 100k
M1HV.IDX	1-Month Highs Volume gt 100k
M1HX.IDX	1-Month Highs Overall
M1LA.IDX	1-Month Lows AMEX
M1LD.IDX	1-Month Lows OTCBB
M1LE.IDX	1-Month Lows ETFS
M1LH.IDX	1-Month Lows Price gt $10
M1LL.IDX	1-Month Lows Price lt $10
M1LN.IDX	1-Month Lows NYSE
M1LQ.IDX	1-Month Lows NASDAQ
M1LU.IDX	1-Month Lows Volume lt 100k
M1LV.IDX	1-Month Lows Volume gt 100k
M1LX.IDX	1-Month Lows Overall
M3HA.IDX	3-Month Highs AMEX
M3HD.IDX	3-Month Highs OTCBB
M3HE.IDX	3-Month Highs ETFS
M3HH.IDX	3-Month Highs Price gt $10
M3HL.IDX	3-Month Highs Price lt $10
M3HN.IDX	3-Month Highs NYSE
M3HQ.IDX	3-Month Highs NASDAQ
M3HU.IDX	3-Month Highs Volume lt 100k
M3HV.IDX	3-Month Highs Volume gt 100k
M3HX.IDX	3-Month Highs Overall
M3LA.IDX	3-Month Lows AMEX
M3LD.IDX	3-Month Lows OTCBB
M3LE.IDX	3-Month Lows ETFS
M3LH.IDX	3-Month Lows Price gt $10
M3LL.IDX	3-Month Lows Price lt $10
M3LN.IDX	3-Month Lows NYSE
M3LQ.IDX	3-Month Lows NASDAQ
M3LU.IDX	3-Month Lows Volume lt 100k
M3LV.IDX	3-Month Lows Volume gt 100k
M3LX.IDX	3-Month Lows Overall
M6HA.IDX	6-Month Highs AMEX
M6HD.IDX	6-Month Highs OTCBB
M6HE.IDX	6-Month Highs ETFS
M6HH.IDX	6-Month Highs Price gt $10
M6HL.IDX	6-Month Highs Price lt $10
M6HN.IDX	6-Month Highs NYSE
M6HQ.IDX	6-Month Highs NASDAQ
M6HU.IDX	6-Month Highs Volume lt 100k
M6HV.IDX	6-Month Highs Volume gt 100k
M6HX.IDX	6-Month Highs Overall
M6LA.IDX	6-Month Lows AMEX
M6LD.IDX	6-Month Lows OTCBB
M6LE.IDX	6-Month Lows ETFS
M6LH.IDX	6-Month Lows Price gt $10
M6LL.IDX	6-Month Lows Price lt $10
M6LN.IDX	6-Month Lows NYSE
M6LQ.IDX	6-Month Lows NASDAQ
M6LU.IDX	6-Month Lows Volume lt 100k
M6LV.IDX	6-Month Lows Volume gt 100k
M6LX.IDX	6-Month Lows Overall
MAHA.IDX	12-Month Highs AMEX
MAHD.IDX	12-Month Highs OTCBB
MAHE.IDX	12-Month Highs ETFS
MAHH.IDX	12-Month Highs Price gt $10
MAHL.IDX	12-Month Highs Price lt $10
MAHN.IDX	12-Month Highs NYSE
MAHQ.IDX	12-Month Highs NASDAQ
MAHU.IDX	12-Month Highs Volume lt 100k
MAHV.IDX	12-Month Highs Volume gt 100k
MAHX.IDX	12-Month Highs Overall
MALA.IDX	12-Month Lows AMEX
MALD.IDX	12-Month Lows OTCBB
MALE.IDX	12-Month Lows ETFS
MALH.IDX	12-Month Lows Price gt $10
MALL.IDX	12-Month Lows Price lt $10
MALN.IDX	12-Month Lows NYSE
MALQ.IDX	12-Month Lows NASDAQ
MALU.IDX	12-Month Lows Volume lt 100k
MALV.IDX	12-Month Lows Volume gt 100k
MALX.IDX	12-Month Lows Overall
MBM.IDX	Fincl Svcs Bridges Baskt Value
MBO.IDX	CHINESE MPS BSKT
MDO.IDX	MID OPN/CLS AVGE
MEB.IDX	ENERGY INDS CPN
MERV.IDX	Merval - Argentina
MEV.IDX	AMEX MEXICO INDEX SETTLEMENT
MFX.IDX	KBW MORTGAGE FINANCE INDEX
MGD.IDX	S&P MidCap 400/BARRA Growth Index
MIA.IDX	MID O/C/H/L AVG
MID.IDX	AMEX S&P Midcap 400 Index
MIH.IDX	MID HI/LO AVGE
MIV.IDX	MID-CAP SETTLE
MLO.IDX	AMEX Merrill Lynch Tech 100
MMFI.IDX	STOCKS ABOVE 50-DAY MA
MMOF.IDX	STOCKS ABOVE 150-DAY MA
MMOH.IDX	STOCKS ABOVE 100-DAY MA
MMTH.IDX	STOCKS ABOVE 200-DAY MA
MMTW.IDX	STOCKS ABOVE 20-DAY MA
MNG.IDX	AMEX MINI-NATURAL GAS INDEX
MNX.IDX	MINI-NASDAQ 100 INDEX
MOX.IDX	Morgan Stanley Internet Index
MOY.IDX	MORGAN STANLEY INTERNET INDEX F
MSH.IDX	AMEX Morgan Stanley Hi Tech 35
MUT.IDX	CBOE DOW TEN INDEX
MUV.IDX	S&P MidCap 400/BARRA Value Index
MVH.IDX	MORGAN STANLEY HIGH-TECHNOLOGY
MVW.IDX	VALUE 30 INDEX
MXX.IDX	Mexico IPC
MXY.IDX	AMEX Mexico Index
MYHA.IDX	YTD Highs AMEX
MYHD.IDX	YTD Highs OTCBB
MYHE.IDX	YTD Highs ETFS
MYHH.IDX	YTD Highs Price gt $10
MYHL.IDX	YTD Highs Price lt $10
MYHN.IDX	YTD Highs NYSE
MYHQ.IDX	YTD Highs NASDAQ
MYHU.IDX	YTD Highs Volume lt 100k
MYHV.IDX	YTD Highs Volume gt 100k
MYHX.IDX	YTD Highs Overall
MYLA.IDX	YTD Lows AMEX
MYLD.IDX	YTD Lows OTCBB
MYLE.IDX	YTD Lows ETFS
MYLH.IDX	YTD Lows Price gt $10
MYLL.IDX	YTD Lows Price lt $10
MYLN.IDX	YTD Lows NYSE
MYLQ.IDX	YTD Lows NASDAQ
MYLU.IDX	YTD Lows Volume lt 100k
MYLV.IDX	YTD Lows Volume gt 100k
MYLX.IDX	YTD Lows Overall
NBI.IDX	Nasdaq Biotechnology
NBZ.IDX	NASDAQ BIOTECH INDEX FINAL SET
NDFI.IDX	Nasdaq 100 Stocks Above 50-Day Average
NDOF.IDX	Nasdaq 100 Stocks Above 150-Day Average
NDOH.IDX	Nasdaq 100 Stocks Above 100-Day Average
NDTH.IDX	CTS FEED DTH
NDTW.IDX	Nasdaq 100 Stocks Above 20-Day Average
NDX.IDX	NASDAQ 100 INDEX
NDXT.IDX	NASDAQ 100 TECHNOLOGY
NDY.IDX	Nasdaq 100
NEX.IDX	WILDERHILL NEW ENERFY GLOBAL INN
NFA.IDX	CTS FEED FA
NFT.IDX	MORGAN STANLEY MULTINATIONAL CO
NGV.IDX	AMEX NATURAL GAS INDEX FINAL SE
NI225.IDX	Nikkei 225
NKN.IDX	AMEX FRO SETTLEMENT QQQQ
NNY.IDX	US 100
NNYE.IDX	ENERGY IDX
NNYI.IDX	INTERNATIONAL 100
NNYK.IDX	FINANCIAL
NNYL.IDX	WORLD LEADERS
NNYP.IDX	HEALTH CARE
NNYY.IDX	TMT IDX
NQGM.IDX	NDAQ GLOBAL MARKET COMPOSITE
NSHD.IDX	NYSE DECLINES
NSHF.IDX	NYSE ADVANCE DECLINE DIFFERENCE
NSHR.IDX	NYSE ADVANCE DECLINES RATIO
NSHU.IDX	NYSE ADVANCES DECLINES
NVLD.IDX	NYSE VOLUME DECLINES
NVLF.IDX	NYSE ADVANCE DECLINE VOLUME DIFF
NVLR.IDX	NYSE ADVANCE DECLINE VOLUME RATI
NVLU.IDX	NYSE VOLUME ADVANCES
NVOT.IDX	NYSE Total Volume
NWO.IDX	DEUTSCHE BANK ENERGY INDEX FINA
NWV.IDX	AMEX NETWORKING INDEX SETTLEMEN
NWX.IDX	AMEX Networking Index
NYA.IDX	NYSE Composite
NZ50.IDX	NZSX 50 Index
OEX.IDX	S&P 100 Index
OFIN.IDX	Nasdaq Other Financial Index
OILBR.IDX	Crude Oil Brent NYMEX
OILSW.IDX	Crude Oil Light Sweet NYMEX
OIV.IDX	CBOE/NYMEX WTI Volatility Index
OIX.IDX	CBOE OIL INDEX
ONE.IDX	S&P 100 Index
OOG.IDX	ISE OIL & GAS SERVICES     INDEX
OOI.IDX	S&P Global 100 Index
OSX.IDX	Phlx Euro Style Oil Svc Index
OVX.IDX	CBOE CRUDE OIL VOLATILITY INDEX
OXH.IDX	Oil Service Holdrs Index
PHN.IDX	AMEX Telecom Index
PLD.IDX	Palladium Index
PLT.IDX	Platinum Index
PMP.IDX	ISE INTEGRATED OIL & G    AS IND
PSE.IDX	Pacific Exchange Technology Index
PTT.IDX	AMEX FRO SETTLEMENT EEM
QQV.IDX	QQQ Volatility Index
QSHD.IDX	NASD DECLINING STOCKS
QSHF.IDX	NASD ADVANCE DECLINE DIFFERENCE
QSHR.IDX	NASD ADVANCE DECLINE RATIO
QSHU.IDX	NASD ADVANCING STOCKS
QVLD.IDX	NASD DECLINING VOLUME
QVLF.IDX	NASD ADVANCE DECLINE VOLUME DIFF
QVLR.IDX	NASD ADVANCE DECLINE VOL RATIO
QVLU.IDX	NASD ADVANCING VOLUME
RAG.IDX	Cboe Russell 3000 Growth Index
RAV.IDX	Cboe Russell 3000 Value Index
RDG.IDX	Cboe Russell Midcap Growth Index
RDL.IDX	FIRST TRST MSTAR DIV LDR
RDM.IDX	FT  DJ SEL MICRO CAP INDEX FUND
RIS.IDX	AMEX FRO SETTLEMENT MSFT
RJY.IDX	S.V. FOR AMEX MINI-NATURAL GAS
RLG.IDX	Cboe 1000 Growth Index
RLX.IDX	S& P RETAIL INDEX
RMC.IDX	Cboe Russell Midcap Index
RMV.IDX	Cboe Russell Midcap Value Index
RMZ.IDX	THE MSCI REIT INDEX
RND.IDX	ISE BIO-PHARMACEUTICALS INDEX
RPE.IDX	AMEX Elec Pwr&Nat Gas Infrastr
RSC.IDX	Russell SmallCap Index
RSG.IDX	Russell SmallCap Growth
RSV.IDX	Russell SmallCap Value
RTF.IDX	RUSSELL TOP 50 INDEX
RTG.IDX	Russell 2500 Growth
RTI.IDX	Russell 2500 Index
RTM.IDX	Russell Microcap Index
RTV.IDX	Russell 2500 Value
RUA.IDX	Russell 3000 Index
RUF.IDX	ISE HOMEBUILDERS INDEX
RUI.IDX	Russell 1000 Index
RUJ.IDX	Cboe Russell Value Index
RUO.IDX	Cboe Russell 2000 Growth Index
RUT.IDX	Russell 2000 Index
RVX.IDX	CBOE RUSSELL 2000 VOLATILITY IN
RWG.IDX	Russell Top 200 Growth
RWI.IDX	Russell Top 200 Index
RWV.IDX	Russell Top 200 Value
RXH.IDX	AMEX M S Healthcare Providr Index
RXP.IDX	AMEX M S Healthcare Products Index
RXS.IDX	Phlx Drug Index
RZP.IDX	AMEX FRO SETTLEMENT XLF
S1FI.IDX	S&P 100 Stocks Above 50-Day Average
S1OF.IDX	S&P 100 Stocks Above 150-Day Average
S1OH.IDX	S&P 100 Stocks Above 100-Day Average
S1TH.IDX	S&P 100 Stocks Above 200-Day Average
S1TR.IDX	S&P 500 Automobiles & Components [TR]
S1TW.IDX	S&P 100 Stocks Above 20-Day Average
S2TR.IDX	S&P 500 Banks [TR]
S3TR.IDX	S&P 500 Capital Goods [TR]
S4FI.IDX	S&P 400 Stocks Above 50-Day Average
S4OF.IDX	S&P 400 Stocks Above 150-Day Average
S4OH.IDX	S&P 400 Stocks Above 100-Day Average
S4TH.IDX	S&P 400 Stocks Above 200-Day Average
S4TR.IDX	S&P 500 -Commercial & Professional Services [TR]
S4TW.IDX	S&P 400 Stocks Above 20-Day Average
S5FI.IDX	S&P 500 Stocks Above 50-Day Average
S5NT.IDX	S&P Custom/Primasia Semi50 Index [TWD] [TR]
S5OF.IDX	S&P 500 Stocks Above 150-Day Average
S5OH.IDX	S&P 500 Stocks Above 100-Day Average
S5TH.IDX	S&P 500 Stocks Above 200-Day Average
S5TR.IDX	S&P 500 Consumer Durables & Apparel [TR]
S5TW.IDX	S&P 500 Stocks Above 20-Day Average
S5US.IDX	S&P Custom/Primasia Semi50 Index [TR]
S6CD.IDX	S&P SmallCap600 Capped Consumer Discretionary [s
S6CS.IDX	S&P SmallCap600 Capped Consumer Staples [sector]
S6EP.IDX	S&P SmallCap600 Capped Energy [sector]Index
S6FI.IDX	S&P 600 Stocks Above 50-Day Average
S6FP.IDX	S&P SmallCap600 Capped Financials [sector]Index
S6HC.IDX	S&P SmallCap600 Capped HealthCare [sector]Index
S6IP.IDX	S&P SmallCap600 Capped Industrials [sector]Index
S6MP.IDX	S&P SmallCap600 Capped Materials [sector]Index
S6OF.IDX	S&P 600 Stocks Above 150-Day Average
S6OH.IDX	S&P 600 Stocks Above 100-Day Average
S6TH.IDX	S&P 600 Stocks Above 200-Day Average
S6TP.IDX	S&P SmallCap600 Capped Information Technology [s
S6TR.IDX	S&P 500 Consumer Services [TR]
S6TW.IDX	S&P 600 Stocks Above 20-Day Average
S6UP.IDX	S&P SmallCap600 Capped Utilities & Telecom Servi
S7TR.IDX	S&P 500 Diversified Financials [TR]
S8TR.IDX	S&P 500 Energy [TR]
S9TR.IDX	S&P 500 Food & Staples Retailing [TR]
SAAA.IDX	S&P Asia Alternative Energy Index
SAAB.IDX	S&P Asia Infrastructure Index
SAAC.IDX	S&P Asia Water Index
SAAE.IDX	RBS Clean Renewable Energy USDTR Index
SAAI.IDX	RBS India ADR/GDRTR Index
SAAM.IDX	RBS Global Metal & Mining TR Index
SAAV.IDX	RBS Vastgoed PR Index [EUR]
SAAW.IDX	RBS Water Stocks USD TR Index
SACC.IDX	Alpha Shares China Small Cap Index
SACN.IDX	Alpha Shares China Technology Index
SACP.IDX	RBS Climate Change & Environment EURPR Index
SACT.IDX	RBS Climate Change & Environment EURTR Index
SAEI.IDX	S&P Global Alternative Energy Index [EURO]
SAER.IDX	S&P GSCI Agriculture Capped Component 35/20 EUR
SAEU.IDX	S&P Global Alternative Energy Index
SAIE.IDX	S&P Africa 40 Index [EURO]
SAIT.IDX	DWS Agri X Index [TR]
SAIU.IDX	S&P Africa 40 Index
SAJR.IDX	MSCI WISE ASIA Ex-Japan Top [Net TR]
SAJT.IDX	MSCI WISE ASIA Ex-Japan Top
SANA.IDX	S&P Agribusiness North America
SANC.IDX	S&P Agribusiness North America CAD
SAPE.IDX	S&P Asia Property 40 Index
SAPT.IDX	S&P GSCI All Metals Capped Commodity 35/20 EUR I
SAPU.IDX	S&P Asia Property 40 Index [EURO]
SAQA.IDX	S&P Global Water Index
SAQE.IDX	S&P Global Water Index [EURO]
SASE.IDX	RBS Solar Energy TR Index
SAUE.IDX	S&P GSCI Agriculture Capped Component 35/20 EUR
SAWP.IDX	RBS Wind PR Index
SAWT.IDX	RBS Wind TR Index
SBAI.IDX	S&P Brazil ADR Index
SBER.IDX	S&P GSCI Biofuel Index Excess Return
SBES.IDX	BLO M Emerging Shariah Index [NetTR]
SBIC.IDX	S&P BMI [Capped]Ireland [USDollar]
SBNP.IDX	S&P Custom/BNP Paribas SPECTRUMUS Sect or Moment
SBRX.IDX	RBS BRIC 11 PR Index
SBSE.IDX	S&P BRIC Shariah Index [EURO]
SBSU.IDX	S&P BRIC Shariah Index
SBTR.IDX	S&P GSCI Biofuel Index Total Return
SBUP.IDX	S&P Food & Beverage Select Industry Index
SBWI.IDX	JP Morgan Bridge Water Index
SC8I.IDX	Core 8 Index
SCBI.IDX	SG I Global Carbon [NetUSD]
SCBR.IDX	S&P BMI Russia [Capped] [USDollar]
SCEI.IDX	CS/RT Emerging Infrastructure Index [NetTR]
SCGD.IDX	Credit Suisse Germany Index
SCGE.IDX	Beacon Global Exchanges Brokers and Asset Manage
SCGO.IDX	Credit Suisse Global Nanotech Index
SCGT.IDX	Beacon Global Timber Index
SCII.IDX	CAT China Infrastructure [TR]
SCIR.IDX	S&P GSCI North American Copper Index Excess Retu
SCIS.IDX	S&P GSCI North American Copper Index
SCIT.IDX	S&P GSCI North American Copper Index Total Retur
SCNI.IDX	IPO X China 20 Index [USD] [P] na Index
SCPC.IDX	S&P Custom/Polaris China Play Index [TWD]
SCPX.IDX	Credit Suisse Germany Price Return Index
SCQI.IDX	Citigroup Quant Idols Index [NetTR]
SCRC.IDX	S&P /CITIC China 30 Index
SCRE.IDX	Alpha Shares China Real Estate Index
SCSC.IDX	S&P /CITIC 300 Index
SCSE.IDX	S&P /CITIC 50 Index
SCSR.IDX	CS/RT Emerging Infrastructure Price Return Index
SCTE.IDX	S&P CTSI Index Excess Return
SCTT.IDX	S&P CTSI Index Total Return
SCTY.IDX	S&P CTSI Index
SCUT.IDX	S&P/CITIC 300 -  Utilities [Sector]
SCVM.IDX	Citigroup Asian Value Momentum Index [NetTR]
SCWI.IDX	CAT China Water [TR]
SCWP.IDX	S&P Developed Ex-U.S.Property [USDollar]
SCYE.IDX	S&P Chinese Renminbi Price Return Index
SCYI.IDX	S&P Chinese Renminbi Total Return
SDCG.IDX	Defined MultiCap Growth Index
SDCI.IDX	DWS Climax Index [EURO] [TR]
SDCV.IDX	Defined MultiCap Value Index
SDDE.IDX	Wisdom Tree Domestic Dividends Index ex Financia
SDDM.IDX	DWA International Developed Markets Technical Le
SDDV.IDX	DWS Top Divide X Index [TR]
SDEM.IDX	DWA International Emerging Markets Technical Lea
SDEW.IDX	S&P 400 Midcap Equal Weighted Index
SDGA.IDX	Delta Global Shipping Index
SDGO.IDX	Defined Large Cap Growth Opportunities Index
SDIP.IDX	S&P DCFI Index Excess Return
SDIS.IDX	S&P DCFIIndex
SDIT.IDX	S&P DCFI Index Total Return
SDLC.IDX	Defined Large Cap Core Index
SDMC.IDX	Defined Mid Cap Core Index
SDPI.IDX	Goldman Sachs BRICs Nifty 50 Developed Markets I
SDSC.IDX	Defined Small Cap Core Index
SDTI.IDX	Goldman Sachs BRICs Nifty 50 Developed Markets I
SDTR.IDX	S&P 500 Food Beverage & Tobacco [TR]
SDTS.IDX	S&P Diversified Trends Indicator
SDTT.IDX	S&P Diversified Trends Total Return Indicator Le
SDVO.IDX	Defined Large Cap Value Opportunities Index
SDWB.IDX	DWS BRIX Index [TR]
SDWG.IDX	DWS Germax Index [TR]
SDWI.IDX	DWS Infrastru X Index [TR]
SEAN.IDX	S&P Southeast Asia 40 Index [NetTR]
SEBI.IDX	S-Network Emerging Infrastructure Builders Index
SECA.IDX	S&P GSCI Enhanced Commodity Index
SECB.IDX	S&P GSCI Enhanced Commodity Index Excess Return
SECC.IDX	S&P GSCI Enhanced Commodity Index Total Return
SEIB.IDX	S-Network Emerging Infrastructure Builders Index
SEIE.IDX	S&P Global Eco Index [EURO]
SEII.IDX	CS/RT Emerging Infrastructure Index
SEIT.IDX	S&P Global REIT [AUD]
SEIU.IDX	S&P Global Eco Index
SEMT.IDX	Brics Nifty 50 Emerging Market Tradable Index Tr
SFTR.IDX	S&P 500 - Pharmaceuticals Biotechnology & Life
SG0A.IDX	S&P GSCI Agriculture & Live Stock Index
SG0B.IDX	S&P GSCI Agriculture & Live Stock Index Excess R
SG0C.IDX	S&P GSCI Agriculture & Live Stock Index Total Re
SG0D.IDX	S&P GSCI Agriculture Index Excess Return
SG0E.IDX	S&P GSCI Agriculture Index Total Return
SG0F.IDX	S&P GSCI All Cattle Index
SG0G.IDX	S&P GSCI All Cattle Index Excess Return
SG0H.IDX	S&P GSCI All Cattle Index Total Return
SG0I.IDX	S&P GSCI All Crude Index
SG1A.IDX	S&P GSCI All Crude Index Total Return
SG1B.IDX	S&P GSCI All Wheat Index
SG1C.IDX	S&P GSCI All Wheat Index Excess Return
SG1D.IDX	S&P GSCI All Wheat Index Total Return
SG1E.IDX	S&P GSCI Aluminum Index
SG1F.IDX	S&P GSCI Aluminum Index Excess Return
SG1G.IDX	S&P GSCI Aluminum Index Total Return
SG1H.IDX	S&P GSCI Soybean Oil Index
SG1I.IDX	S&P GSCI Soybean Oil Index Excess Return
SG1J.IDX	S&P GSCI All Crude Index Excess Return
SG2A.IDX	S&P GSCI Brent Crude Index
SG2B.IDX	S&P GSCI Brent Crude Index Excess Return
SG2C.IDX	S&P GSCI Brent Crude Index Total Return
SG2D.IDX	S&P GSCI Cocoa Index
SG2E.IDX	S&P GSCI Cocoa Index Excess Return
SG2F.IDX	S&P GSCI Cocoa Index Total Return
SG2G.IDX	S&P GSCI Coffee Index Co Index
SG2H.IDX	S&P GSCI Coffee Index Excess Return
SG2I.IDX	S&P GSCI Coffee Index Total Return
SG2J.IDX	S&P GSCI Soybean Oil Index Total Return
SG3A.IDX	S&P GSCI Copper Index Excess Return
SG3B.IDX	S&P GSCI Copper Index Total Return
SG3C.IDX	S&P GSCI Corn Index
SG3D.IDX	S&P GSCI Corn Index Excess Return
SG3E.IDX	S&P GSCI Corn Index Total Return
SG3F.IDX	S&P GSCI Cotton Index
SG3G.IDX	S&P GSCI Cotton Index Excess Return
SG3H.IDX	S&P GSCI Cotton Index Total Return
SG3I.IDX	S&P GSCI Crude Oil Index
SG3J.IDX	S&P GSCI Copper Index
SG4A.IDX	S&P GSCI Crude Oil Index Total Return
SG4B.IDX	S&P GSCI Energy and Metals Index
SG4C.IDX	S&P GSCI Energy and Metals Index Excess Return
SG4D.IDX	S&P GSCI Energy and Metals Index Total Return
SG4E.IDX	S&P GSCI Energy Index Excess Return
SG4F.IDX	S&P GSCI Energy Index Total Return
SG4G.IDX	S&P GSCI Feeder Cattle Index
SG4H.IDX	S&P GSCI Feeder Cattle Index Excess Return
SG4I.IDX	S&P GSCI Feeder Cattle Index Total Return
SG4J.IDX	S&P GSCI Crude Oil Index Excess Return
SG5A.IDX	S&P GSCI Gas Oil Index Excess Return
SG5B.IDX	S&P GSCI Gas Oil Index Total Return
SG5C.IDX	S&P GSCI Gold Index
SG5D.IDX	S&P GSCI Gold Index Excess Return
SG5E.IDX	S&P GSCI Gold Index Total Return
SG5F.IDX	S&P GSCI Grains Index
SG5G.IDX	S&P GSCI Grains Index Excess Return
SG5H.IDX	S&P GSCI Grains Index Total Return
SG5I.IDX	S&P GSCI Heating Oil Index
SG5J.IDX	S&P GSCI Gas Oil Index
SG6A.IDX	S&P GSCI Heating Oil Index Total Return
SG6B.IDX	S&P GSCI Industrial Metals Index Excess Return
SG6C.IDX	S&P GSCI Industrial Metals Index Total Return
SG6D.IDX	S&P GSCI Kansas Wheat Index
SG6E.IDX	S&P GSCI Kansas Wheat Index Excess Return
SG6F.IDX	S&P GSCI Kansas Wheat Index Total Return
SG6G.IDX	S&P GSCI Lead Index
SG6H.IDX	S&P GSCI Lead Index Excess Return
SG6I.IDX	S&P GSCI Lead Index Total Return
SG6J.IDX	S&P GSCI Heating Oil Index Excess Return
SG7A.IDX	S&P GSCI Lean Hogs Index Excess Return
SG7B.IDX	S&P GSCI Lean Hogs Index Total Return
SG7C.IDX	S&P GSCI Light Energy Index [CPW4]
SG7D.IDX	S&P GSCI Light Energy Index [CPW4] Excess Return
SG7E.IDX	S&P GSCI Light Energy Index [CPW4] Total Return
SG7F.IDX	S&P GSCI Live Cattle Index
SG7G.IDX	S&P GSCI Live Cattle Index Excess Return
SG7H.IDX	S&P GSCI Live Cattle Index Total Return
SG7I.IDX	S&P GSCI Livestock Index Excess Return
SG7J.IDX	S&P GSCI Lean Hogs Index
SG8A.IDX	S&P GSCI Natural Gas Index
SG8B.IDX	S&P GSCI Natural Gas Index Excess Return
SG8C.IDX	S&P GSCI Natural Gas Index Total Return
SG8D.IDX	S&P GSCI Nickel Index
SG8E.IDX	S&P GSCI Nickel Index Excess Return
SG8F.IDX	S&P GSCI Nickel Index Total Return
SG8G.IDX	S&P GSCI Non-Energy Index Excess Return
SG8H.IDX	S&P GSCI Non-Energy Index
SG8I.IDX	S&P GSCI Non-Energy Index Total Return
SG8J.IDX	S&P GSCI Livestock Index Total Return
SG9A.IDX	S&P GSCI Non-Livestock Index Excess Return
SG9B.IDX	S&P GSCI Non-Livestock Index Total Return
SG9C.IDX	S&P GSCI Non-Natural Gas Index
SG9D.IDX	S&P GSCI Non-Natural Gas Index Excess Return
SG9E.IDX	S&P GSCI Non-Natural Gas Index Total Return
SG9F.IDX	S&P GSCI Non-Precious Index
SG9G.IDX	S&P GSCI Non-Precious Index Excess Return
SG9H.IDX	S&P GSCI Non-Precious Index Total Return
SG9I.IDX	S&P GSCI Petroleumex-Gas Oil Index
SG9J.IDX	S&P GSCI Non-Livestock Index
SGAA.IDX	S&P Global Agribusiness Composite Index USD
SGAB.IDX	S&P Global Agribusiness Composite Index EUR
SGAC.IDX	S&P Global Agribusiness Equity Index
SGAD.IDX	S&P Global Agribusiness Equity Index [EURO]
SGAG.IDX	IQ AGRI PLACE HOLDER
SGCC.IDX	S&P GSCI Capped Commodity 35/20 Index
SGCE.IDX	SGI Global Carbon
SGCP.IDX	IQ CPI Inflation Tracker Index
SGCR.IDX	S&P GSCI All Metals Capped Index Excess Return
SGDO.IDX	S&P Global Dividend Opportunities Index
SGED.IDX	IQ Hedge Event-Driven Index
SGEI.IDX	Credit Suisse Emerging Market Infrastructure Ind
SGEP.IDX	Credit Suisse Emerging Market Infrastructure Pri
SGET.IDX	Goldman Sachs Liquefied Natural Gas Index [EURO]
SGEY.IDX	Credit Suisse Emerging Market Infrastructure Ind
SGGE.IDX	S-Network Global Gaming Index [EURO]
SGGM.IDX	IQ Hedge Macro Index
SGGN.IDX	IQ GLOBAL RESOURCES INDEX
SGGS.IDX	IQ Australia Small Cap
SGIA.IDX	S&P North American Natural Resources Sector Inde
SGIB.IDX	S&P North American Technology Sector Index
SGIC.IDX	S&P North American Technology Hardware Index
SGID.IDX	S&P North American Technology Software Index
SGIE.IDX	S&P North American Technology Services Index
SGIF.IDX	S&P North American Technology Multimedia Network
SGIG.IDX	S&P North American Technology Internet Index
SGIH.IDX	S&P North AmericanT echnology Semiconductors Ind
SGIR.IDX	S&P GSCI All Metals Index Excess Return
SGJ.IDX	S&P GSCI Energy
SGK.IDX	S&P GSCI Agriculture
SGLE.IDX	Goldman Sachs Liquefied Natural Gas Index [EURO]
SGLN.IDX	SGI Global Security Index [EURO] [TR]
SGLS.IDX	SGI Global Security Index [EURO]
SGLT.IDX	Goldman Sachs Liquefied Natural Gas Index [TR]
SGMA.IDX	S&P GSCI All Metals Index
SGME.IDX	SGI Global Momentum [NetTR] [EURO] [NetTR] [NEWV
SGMN.IDX	IQ Hedge Market Neutral Index
SGMS.IDX	IQ Hedge Multi-Strategy Index
SGMU.IDX	SGI Global Momentum [NetTR] [NEWVA]
SGNC.IDX	Credit Suisse Global Nanotech Index  [SWISS FRAN
SGNM.IDX	IQ Merger Arbitrage Index Merger Arrage Index
SGNX.IDX	Credit Suisse Global Nanotech Index [EURO]
SGON.IDX	S&P Global Dividend Opportunities Index [NetTR]
SGOS.IDX	IQ South Korea Small Cap
SGP.IDX	S&P GSCI Precious Metals
SGPA.IDX	S&P GSCI All Metals Capped Index
SGPG.IDX	S&P GSCI Agriculture Capped Index
SGPP.IDX	S&P GSCI Capped Commodity 35/20 Index Excess Ret
SGPR.IDX	S&P GSCI Agriculture Capped Index Total Return
SGPT.IDX	S&P GSCI Capped Commodity 35/20 Index Total Retu
SGQA.IDX	S&P GSCI Petroleumex-Gas Oil Index Total Return
SGQB.IDX	S&P GSCI Petroleum Index
SGQC.IDX	S&P GSCI Petroleum Index Excess Return
SGQD.IDX	S&P GSCI Petroleum Index Total Return
SGQE.IDX	S&P GSCI Precious Metals Index Excess Return
SGQF.IDX	S&P GSCI Precious Metals Index Total Return
SGQG.IDX	S&P GSCI Reduced Energy Index [CPW2]
SGQH.IDX	S&P GSCI Reduced Energy Index [CPW2] Excess Retu
SGQI.IDX	S&P GSCI Reduced Energy Index [CPW2] Total Retur
SGQJ.IDX	S&P GSCI Petroleumex GasOil Index Excess Return
SGRC.IDX	S&P GSCI All Metals Capped Commodity 35/20 EUR I
SGRE.IDX	S&P GSCI All Metals Capped Commodity 35/20 EUR I
SGRG.IDX	S&P GSCI Agriculture Capped Index Excess Return
SGRM.IDX	Cohen & Steers Global Realty Majors Portfolio [T
SGRT.IDX	S&P GSCI Agriculture Capped Component 35/20 EUR
SGSA.IDX	S&P GSCI Silver Index
SGSB.IDX	S&P GSCI Silver Index Excess Return
SGSC.IDX	S&P GSCI Silver Index Total Return
SGSD.IDX	S&P GSCI Soybeans Index
SGSE.IDX	S&P GSCI Excess Return
SGSF.IDX	S&P GSCI Soybeans Index Excess Return
SGSG.IDX	S&P GSCI Soybeans Index Total Return
SGSH.IDX	S&P GSCI Sugar Index
SGSJ.IDX	S&P GSCI Sugar Index Excess Return
SGSK.IDX	S&P GSCI Sugar Index Total Return
SGSL.IDX	Goldman Sachs Liquefied Natural Gas Index
SGSM.IDX	S&P GSCI Ultra-Light Energy Index [CPW8] Excess
SGSN.IDX	S&P GSCI Ultra-Light Energy Index [CPW8] Total R
SGSO.IDX	S&P GSCI Unleaded Gasoline Index
SGSP.IDX	S&P GSCI Unleaded Gasoline Index Excess Return
SGSQ.IDX	S&P GSCI Unleaded Gasoline Index Total Return
SGSR.IDX	S&P GSCI Wheat Index
SGSS.IDX	S&P GSCI Wheat Index Excess Return
SGST.IDX	S&P GSCI Wheat Index Total Return
SGSU.IDX	S&P GSCI Zinc Index
SGSV.IDX	S&P GSCI Zinc Index Excess Return
SGSW.IDX	S&P GSCI Zinc Index Total Return
SGSX.IDX	S&P GSCI Ultra-LightEnergyIndex [CPW8]
SGT.IDX	S&P GSCI Total Return
SGTR.IDX	S&P GSCI All Metals Capped Index Total Return
SGV.IDX	CASINO GAMING
SGWA.IDX	Credit Suisse Global Warming Index Exchange Seri
SGWC.IDX	Credit Suisse Global Warming Price Index
SGWE.IDX	Credit Suisse Global Warming Index EUR
SGWI.IDX	Credit Suiss eGlobal Warming Index Exchange Seri
SGWM.IDX	Credit Suisse Global Warming Index
SGWN.IDX	SGI Global Wealth Effect [NetTR]
SGWP.IDX	SGI Global Wealth Effect
SGWT.IDX	S&P GSCI Select Equal Weight Index Tr
SGX.IDX	S&P GSCI FPI Index
SGY.IDX	S&P GSCI Industrial Metals
SHEP.IDX	Credit Suisse Hs60 Europe Index Powered By Holt
SHEU.IDX	HS60 Europe Index
SHGL.IDX	IQ Hedge Long/Short Index
SHLD.IDX	Credit Suisse Healthy Living Index USD
SHLP.IDX	Credit Suisse Healthy Living Price Index
SHLS.IDX	Credit Suisse Healthy Living Price Index USD
SHLX.IDX	Credit Suisse Healthy Living Index
SHSB.IDX	HS60 Index
SHSD.IDX	HS60-EURO Index
SHTR.IDX	S&P 500 HealthCare Equipment & Services [TR]
SHUS.IDX	HS60 US Index
SIDO.IDX	S&P International Dividend Opportunities Index
SIII.IDX	Indus India Index
SIIN.IDX	S&P India Select Index
SIIP.IDX	S&P DFFI Index Excess Return
SIIS.IDX	S&P DFFI Index
SIIT.IDX	S&P DFFI Index Total Return
SIN.IDX	DJ Industrial
SINE.IDX	S&P India 10 Index [EURO]
SINU.IDX	S&P India 10 Index
SIPA.IDX	IPOX-30 Asia [USD] [P]
SIPC.IDX	IPOX Global 30 Index [USD] [P]
SIPO.IDX	IPOX-100 U.S. [USD] [P]
SIPR.IDX	Brics Nifty 50 Emerging Market Tradable Index Pr
SIPT.IDX	IPOX-30 U.S. [USD] [P]
SIRI.IDX	S&P Indian Rupee Total Return
SIRP.IDX	Cohen & Steers International Realty Majors Portf
SIS.IDX	AMEX Semiconductor Index
SITR.IDX	S&P 500 Insurance [TR]
SIUT.IDX	S&P 500 2x Inverse Daily Index
SIXO.IDX	JP Morgan IPOX Europe 50 Index EUR [P]
SIXT.IDX	IPOX-30 Europe [EURO] [P]
SJEJ.IDX	S&P Japan Eco [JPY]
SJGA.IDX	Janney Global Water Index
SJGE.IDX	Janney Global Water Index [EURO]
SJPA.IDX	S&P Japan 500
SJPB.IDX	S&P Japan Mid Cap 100
SJPC.IDX	S&P Japan Small Cap 250 Index
SJPD.IDX	S&P TOPIX YEN
SJPE.IDX	S&P JES100
SJRI.IDX	S&P Japan Regional Index-Tokai
SJTA.IDX	Janney Water Tech
SJTE.IDX	Janney Water Tech [EURO]
SJTR.IDX	S&P 500 Semiconductors & Semiconductor Equipment
SJWA.IDX	Janney Water Works
SJWE.IDX	Janney Water Works [EURO]
SKTR.IDX	S&P 500 Materials [TR]
SLAC.IDX	S&P LAC40 [US$] [EURO] [NetTR]
SLCG.IDX	Wisdom Tree Large Cap Growth Index
SLCN.IDX	S&P US Carbon Efficient Index U.S. Carbci Index
SLCT.IDX	S&P U.S. Carbon Efficient Index [TR]
SLCU.IDX	S&P U.S. Carbon Efficient Index [NetTR]
SLEE.IDX	S&P GSCI Light Energy EUR Index
SLER.IDX	S&P GSCI Light Energy EUR Index ER
SLEW.IDX	S&P 600 Smallcap Equal Weighted Index
SLPE.IDX	Global Listed Private Equity Index
SLPX.IDX	Cushing 30 MLP Index USD Price Return
SLQR.IDX	S&P  500 Low Quality Rankings
SLRT.IDX	S&P GSCI Light Energy EUR Index TR
SLUN.IDX	S&P 500 2x Leverage Daily Index
SLUT.IDX	S&P 500 Gold Hedged Index
SLV.IDX	Silver Index
SMIS.IDX	RBS Emerging Market Infrastructure Strategy Inde
SML.IDX	S&P Small Caps 600 Index
SMPR.IDX	Goldman Sachs BRICs Nifty 50 Emerging Markets In
SMRW.IDX	Revenue Shares MidCap Fund
SMSS.IDX	Morgan Stanley Smart Money Equity Index [TR]
SMTA.IDX	IQ Taiwan Small Cap Index PALCE HOLDER
SMTI.IDX	Goldman Sachs BRICs Nifty 50 Emerging Markets In
SMTR.IDX	S&P GSCI All Metals Index Total Return
SMXT.IDX	DWS Mega Trends Index [NetTRw/fees]
SN0G.IDX	S-Net ITG Agriculture Index
SN0H.IDX	S-Net ITG Agriculture Index [EURO]
SN0I.IDX	S-Net ITG Agriculture Index [NetTR]
SN1J.IDX	S-Net ITG Agriculture Index [EURO] [NetTR]
SNAC.IDX	Alpha Shares China All Cap Index
SNCE.IDX	Next 11 Core 5 Index
SNCH.IDX	Next 11 Core 8 Index
SNCT.IDX	Next 11 Core 8 Index [TR]
SNEI.IDX	S&P Global Nuclear Energy Index [EURO]
SNER.IDX	S&P GSCI Non-Energy EUR IndexER
SNEU.IDX	S&P Global Nuclear Energy Index
SNIE.IDX	S-Network Global Nuclear Index [EURO]
SNIU.IDX	S-Network Global Nuclear Index
SNNE.IDX	S&P Global Infrastructure Index [EURO] [NetTR]
SNNT.IDX	S&P Global Infrastructure Index [NetTR]
SNPS.IDX	MPF/Noble Professional Services Index
SNPT.IDX	MPF/Noble Professional Services Index [TotalRetu
SNRE.IDX	S&P Global Natural Resources Index [EURO]
SNRT.IDX	S&P GSCI Non-Energy EUR Index TR
SNRU.IDX	S&P Global Natural Resources Index
SNTE.IDX	Next 11 Core 5 Index [TR]
SNUI.IDX	S&P GSCI Non-Energy EUR Index
SOBC.IDX	SGI-Orbeo Carbon Credit Index [EUR-TotalReturn]
SOCC.IDX	SGI-Orbeo Carbon Credit Index [USD-TotalReturn]
SOTR.IDX	S&P 500 Media [TR]
SP500.IDX	S&P 500
SPAA.IDX	SGI Pan Africa Index [NetTR] Panri Indexet
SPAB.IDX	SGI Pan Africa Index [EURO] [NetTR]
SPAC.IDX	SGI Pan Africa Index
SPAD.IDX	S&P GSCI Palladium Index
SPEE.IDX	S&P Listed Private Equity Index [EURO]
SPER.IDX	S&P GSCI Palladium Index Excess Return
SPEY.IDX	S&P Listed Private Equity Index
SPIN.IDX	S&P GSCI Platinum Index
SPIR.IDX	S&P GSCI Platinum Index Excess Return
SPLR.IDX	S&P GSCI Platinum Index Total Return
SPMIB.IDX	FTSE/MIB 40
SPPR.IDX	S&P International Preferred Stock Index
SPRL.IDX	SGI Premium List [NetTR]
SPRT.IDX	S&P GSCI Palladium Index Total Return
SPSE.IDX	S&P Custom/Primasia Semi 50 Index
SPSI.IDX	PIMCO SPTR Master Index RT
SPSU.IDX	S&P COMPOSITE 1500 INDEX
SPSW.IDX	S&P Custom/Primasia Semi 50 Index [TWD]
SPSX.IDX	PIMCOTRAKRS IndexRT
SPTR.IDX	Next 11 Pakistan Index [TotalReturn] [TR]
SPUS.IDX	S&P  Global Ex-U.S. Property [US Dollar]
SPX.IDX	S&P 500 INDEX
SPXT.IDX	S&P 500 [TR]
SQIN.IDX	Credit Suisse Industrial Metals Equity Total Ret
SQNG.IDX	Credit Suisse Natural Gas Equity Total Return In
SQPM.IDX	Credit Suisse Precious Metals Equity Total Retur
SQPT.IDX	Credit Suisse Petroleum Equity Total Return Inde
SQTR.IDX	S&P 500 Software & Services [TR]
SQY.IDX	AMEX FRO SETTLEMENT SPY
SRER.IDX	S&P Indian Rupee Price Return Index
SRFF.IDX	SGI Fed Funds Index
SRIC.IDX	S&P BRIC 40 Index [NetTR]
SRIE.IDX	S&P BRIC 40 Index [EURO] [NetTR]
SRLI.IDX	Robb Report Global Luxury Index
SRMP.IDX	Cohen & Steers US Realty Majors Portfolio [TR]
SRPR.IDX	S&P Global REIT [USD]
SRTR.IDX	S&P 500 Real Estate [TR]
SRUE.IDX	S&P Russia 10 Index [EURO]
SRUP.IDX	S&P 500 High Quality Rankings Index
SRUU.IDX	S&P Russia 10 Index
SRVA.IDX	Rogers Energy Producers Index [EURO]
SRVB.IDX	Rogers Metals Producers Index [EURO]
SRVC.IDX	Rogers Agricultural Producers Index [EURO]
SRVD.IDX	Rogers Energy Producers Index
SRVE.IDX	Rogers Metals Producers Index
SRVF.IDX	Rogers Agricultural Producers Index
SRVG.IDX	Rogers Producers Index
SRVH.IDX	Rogers Producers US Extra Liquid Index
SRVI.IDX	Rogers Producers Index [EURO]
SRVJ.IDX	Rogers Producers US Extra Liquid Index [EURO]
SRWI.IDX	Revenue Shares Large Cap Fund
SS1E.IDX	S&P 500 EQUAL WEIGHTED Materials [Sector]
SS1J.IDX	S&P 500 EQUAL WEIGHTED Energy [Sector]
SS2E.IDX	S&P 500 EQUAL WEIGHTED Consumer Discretionary [S
SS2J.IDX	S&P 500 EQUAL WEIGHTED Industrials [Sector]
SS3E.IDX	S&P 500 EQUAL WEIGHTED HealthCare [Sector]
SS3J.IDX	S&P 500 EQUAL WEIGHTED Consumer Staples [Sector]
SS4E.IDX	S&P 500 EQUAL WEIGHTED Information Technology [S
SS4J.IDX	S&P 500 EQUAL WEIGHTED Financials [Sector]
SS5E.IDX	S&P 500 EQUAL WEIGHTED Utilities [Sector]
SS5J.IDX	S&P 500 EQUAL WEIGHTED Telecommunication Service
SSAE.IDX	S&P Southeast Asia 40 Index [EURO]
SSAI.IDX	S&P Southeast Asia 40 Index [EURO] [NetTR]
SSAU.IDX	S&P Southeast Asia 40 Index
SSAX.IDX	S&P Asia50
SSBE.IDX	S&P BRIC 40 Index [EURO]
SSBR.IDX	S&P BRIC 40 Index
SSCA.IDX	S&P Asia Pacific Emerging BMI [USDollar]
SSCB.IDX	S&P Mid-East and Africa BMI [USDollar]
SSCC.IDX	Schwab Smallcap Index
SSCE.IDX	S&P /Citigroup BMI EPAC Index
SSCH.IDX	S&P China BMI [USDollar]
SSCI.IDX	IQ Canada SmallCap
SSCK.IDX	S&P EM BMI [USDollar]
SSCL.IDX	S&P Latin America BMI [USDollar]
SSCM.IDX	Schwab 1000 Index
SSCP.IDX	S&P /Citigroup BMI Asia Pacific Index
SSCQ.IDX	S&P European Emerging BMI [CAPPED] [USDollar]
SSCS.IDX	S&P Developed Ex US Under USD 2 Billion [USDolla
SSCU.IDX	S&P /Citigroup BMI Europe Index
SSCW.IDX	S&P Developed Ex-U.S.BMI [USDollar]
SSDI.IDX	S&P 500 Dividend Index
SSEC.IDX	Shanghai Composite
SSEN.IDX	SGI Global Senior [NetTR]
SSER.IDX	SPECTRUM-Long/Short 8% Index ER [NEWVA]
SSEW.IDX	S&P GSCI Select Equal Weight Index Spot
SSFA.IDX	Credit Suisse Family Index
SSFB.IDX	SGI Double Short Bund Index
SSFE.IDX	Credit Suisse Family Index [EUR] [Price Return]
SSFP.IDX	Credit Suisse Family Index [USD] [Price Return]
SSFT.IDX	Credit Suisse Family Index [CHF] [Price Return]
SSFU.IDX	Credit Suisse Family Index EUR
SSGA.IDX	SGI Global Agriculture
SSGB.IDX	S&P GSCI Biofuel Index
SSGC.IDX	S&P GSCI Enhanced Capped Index
SSGD.IDX	S&P GLOBAL1200-Consumer Discretionary [Sector]
SSGE.IDX	S&P GLOBAL1200-Energy [Sector]
SSGF.IDX	S&P GLOBAL1200-Financials [Sector]
SSGG.IDX	SGI Global Generics Index [EURO] [NetTR]
SSGH.IDX	S&P GLOBAL1200-HealthCare [Sector]
SSGI.IDX	S&P GLOBAL1200-Information Technology [Sector]
SSGL.IDX	S&P GLOBAL1200
SSGM.IDX	S&P GLOBAL1200-Materials [Sector]
SSGN.IDX	S&P GLOBAL1200-Industrials [Sector]
SSGO.IDX	S&P GSCI E27 WTI Index
SSGP.IDX	S&P GSCI Enhanced Capped Index Excess Return
SSGR.IDX	S&P GSCI Enhanced Capped Index Total Return
SSGS.IDX	S&P GLOBAL1200-Consumer Staples [Sector]
SSGT.IDX	S&P GLOBAL1200-Telecommunication Services [Secto
SSGU.IDX	S&P GLOBAL1200-Utilities [Sector]
SSGX.IDX	S&P GSCI E27WTI Index Excess Return
SSGZ.IDX	S&P GSCI E27WTI Index Total Return
SSHE.IDX	S&P Europe 350 Shariah Index
SSHF.IDX	Credit Suisse Family Index CHF
SSHJ.IDX	S&P Japan 500 Shariah Index
SSHX.IDX	S&P 500 Shariah Index
SSIA.IDX	Credit Suisse Social Awareness Index
SSIB.IDX	S&P GSCI Softs Index Excess Return
SSIC.IDX	S&P GSCI Softs Index Total Return
SSIP.IDX	S&P DFI Index Excess Return
SSIS.IDX	S&P DFI Index
SSIT.IDX	S&P DFI Index Total Return
SSKE.IDX	Credit Suisse Nordics Index Sek
SSKP.IDX	Credit Suisse Nordics Price Index  Sek
SSLF.IDX	S&P Select Frontier Index
SSLS.IDX	S&P Custom/BNP Paribas-SPECTRUM [GRIPTEST]
SSMI.IDX	Swiss Market
SSNI.IDX	SGI Global Nanotechnology Index [NetTR]
SSPA.IDX	S&P ADR Index
SSPE.IDX	S&P EUROPE 350
SSPF.IDX	S&P EUROPE 350 - Financials [Sector]
SSPI.IDX	S&P EUROPE 350 - Information Technology [Sector]
SSPL.IDX	S&P 500Telecom&IT
SSPN.IDX	S&P 500Energy[Sector]
SSPR.IDX	S&P 500 O - Strip Index
SSPS.IDX	S&P 500Financials[Sector]
SSPT.IDX	S&P EUROPE 350 - Telecommunication Services [Sec
SSPU.IDX	S&P EURO
SSRF.IDX	S&P Preferred Stock Index
SSRW.IDX	Revenue Shares Small Cap Fund
SSTR.IDX	SPECTRUM-Long/Short 8% Index TR [NEWVA]
SSTU.IDX	S&P 500 EQUAL WEIGHTED Utilities & Telecommunica
SSUC.IDX	S&P GSCI Capped Component 35/20 Index
SSUP.IDX	S&P GSCI Capped Component 35/20 Index Excess Ret
SSUT.IDX	S&P GSCI Capped Component 35/20 Index Total Retu
SSWP.IDX	S&P GSCI Select Equal Weight Index Er
SSWT.IDX	Credit Suisse Water Index
SSXP.IDX	Credit Suisse Social Awareness Index [Price]
SSXT.IDX	DWS Swi X Index [NetTRw/fees]
STCE.IDX	S&P Global Clean Energy Index [EURO]
STCL.IDX	S&P Global Clean Energy Index
STDA.IDX	S&P Target Date Retirement Income Index
STDB.IDX	S&P Target Date 2010 Index
STDC.IDX	S&P Target Date 2015 Index
STDD.IDX	S&P Target Date 2020 Index
STDE.IDX	S&P Target Date 2025 Index
STDF.IDX	S&P Target Date 2030 Index
STDG.IDX	S&P Target Date 2035 Index
STDH.IDX	S&P Target Date 2040 Index
STDI.IDX	S&P Target Date 2045 Index
STFE.IDX	S&P Global Timber and Forestry Index [EURO]
STFU.IDX	S&P Global Timber and Forestry Index
STI.IDX	Straits Times - Singapore
STIC.IDX	S&P CTI Total Return USD
STIF.IDX	S&P Global Infrastructure Index [EURO]
STIL.IDX	SGI Smart WTI Long Invest Index [NEWVA]
STIR.IDX	S&P Global Infrastructure Index
STIS.IDX	S&P Commodity Trends Indicator
STMP.IDX	Tortoise MLP Index
STOXX.IDX	DJ Stoxx 50 Index Euro
STRA.IDX	S&P Target Risk Aggressive Index
STRB.IDX	S&P Target Risk Moderate Index
STRC.IDX	S&P Target Risk Growth Index
STRD.IDX	S&P Target Risk Conservative Index
STRL.IDX	S&P LAC40 [US$] [NetTR]
STRN.IDX	S&P 500 [NetTR]
STRP.IDX	Credit Suisse Water Index [Usd] Price
STRS.IDX	S&P 500 TR Short
STRT.IDX	S&P 500 Telecommunication Services [TR]
STRU.IDX	S&P 500 Household & Personal Products [TR]
STSI.IDX	SGI Smart WTI Short Invest Index [NEWVA]
STSU.IDX	S&P TOP IX150 Shariah [USD]
STSY.IDX	S&P TOP IX150 Shariah
STTR.IDX	S&P 500 Technology Hardware & Equipment [TR]
SUCD.IDX	S&P Select Sector Capped 20% Consumer Discretion
SUCS.IDX	S&P Select Sector Capped 20% Consumer Staples In
SUEP.IDX	S&P Select Sector Capped 20% Energy Index Net TR
SUFP.IDX	S&P Select Sector Capped 20% Financials Index Ne
SUHC.IDX	S&P Select Sector Capped 20% HealthCare Index Ne
SUIP.IDX	S&P Select Sector Capped 20% Industrials Index N
SUJP.IDX	S&P Mitsubishi Corporate Group Index
SUKP.IDX	S&P United Kingdom [PDS]
SUKS.IDX	S&P United Kingdom [USD]
SUMI.IDX	S&P Select Sector Capped 20% Materials Index Net
SUNI.IDX	MAC GLOBAL SOLAR INDEX
SUPI.IDX	S&P Select Sector Capped 20% Utilities Index Net
SURI.IDX	S&P /Citigroup BMI REIT SUS Index
SUTP.IDX	S&P Select Sector Capped 20% Technology Index Ne
SVMI.IDX	Citi Asian Value & Momentum [K] Index
SVTR.IDX	Next 11 Vietnam [TotalReturn] Index
SVUS.IDX	Credit Suisse US Value Index
SW0A.IDX	S&P /Citigroup BMI World Marine Index
SW0B.IDX	S&P Developed Ex-U.S.BMI [Capped] Energy
SW0C.IDX	S&P Developed Ex-U.S.BMI [Capped] Materials
SW0D.IDX	S&P Developed Ex-U.S.BMI [Capped] Industrials
SW0E.IDX	S&P Developed Ex-U.S.BMI [Capped] Consumer Discr
SW0F.IDX	S&P Developed Ex-U.S.BMI [Capped] Consumer Stapl
SW0G.IDX	S&P Developed Ex-U.S.BMI [Capped] HealthCare
SW0H.IDX	S&P Developed Ex-U.S.BMI [Capped] Financials
SW0I.IDX	S&P Developed Ex-U.S.BMI [Capped] Information Te
SW1A.IDX	S&P Developed Ex-U.S.BMI [Capped] Utilities
SW1B.IDX	S&P Developed Ex-U.S.Cap Range Companies Between
SW1C.IDX	S&P Emerging Under USD 2 Billion
SW1J.IDX	S&P Developed Ex-U.S.BMI [Capped] Telecommunicat
SWCH.IDX	Credit Suisse Water Index  [Chf]
SWCT.IDX	S&P World Commodity Index Total Return World Com
SWDI.IDX	VTL Navellier Revenue Weighted Index
SWDR.IDX	VTL Revenue Weighted ADR Index
SWER.IDX	S&P World Commodity Index Excess Return
SWET.IDX	Credit Suisse Water Index [Euro]
SWFI.IDX	Revenue Shares Large Cap Fund Financials [Sector
SWIB.IDX	SGI Wise Bottom
SWIT.IDX	SGI Wise Top
SWML.IDX	Wachovia MLP Index
SWSP.IDX	S&P World Commodity Index
SWTD.IDX	IPOX Global 30 Developed Markets [EURO] [P]
SWTE.IDX	Wisdom Tree Earnings 500 Index
SWTI.IDX	Revenue Shares Large Cap Fund Information Techno
SWTM.IDX	Wisdom Tree Mid Cap Earnings Index
SWTS.IDX	Wisdom Tree Small Cap Earnings Index
SWTT.IDX	Wisdom Tree Earnings Index
SWTV.IDX	Wisdom Tree Large Cap Value Index
SWUB.IDX	SGI Wise US Bottom
SWUL.IDX	SGI Wise US Long/Short [NEWVA]
SWUT.IDX	SGI WISE US Top
SXTR.IDX	S&P 500 Utilities [Industry Group] [TR]
SYTR.IDX	S&P 500 Transportation [Industry Group] [TR]
SZTR.IDX	S&P 500 Retailing [Industry Group] [TR]
TA100.IDX	TA 100 - Israel
TACK.IDX	AMEX TICK
TACX.IDX	AMEX TRIN
TBA.IDX	AMEX FRO SETTLEMENT IDX GOOG
TBO.IDX	AMEX TOBACCO INDEX SETTLEMENT
TEN.IDX	10 YR US TREASURY
TICK.IDX	NYSE Issues Up/Down Ratio
TICX.IDX	NYSE TICK
TIKI.IDX	DIJA Issues Up/Down Ratio
TIKX.IDX	DOW TICK
TLG.IDX	AMEX FRO SETTLEMENT GS
TNX.IDX	10-YEAR TREASURY NOTE
TNY.IDX	ISE-CCM NANOTECHNOLOGY INDEX
TOB.IDX	AMEX Tobacco Index
TOP.IDX	AMEX Eurotop 100 Index
TPN.IDX	Ten Cos Bridges Basket Value Index
TQCK.IDX	NASD TICK
TQCX.IDX	NASD TRIN
TRA.IDX	Nasdaq Transportation
TRIA.IDX	AMEX TRIN
TRIN.IDX	NYSE Short Term Trade Index
TRIQ.IDX	NASD TRIN
TSB.IDX	AMEX FRO SETTLEMENT IDX IBM
TSE.IDX	TSX 60 INDEX
TSV.IDX	TSX VENTURE
TSX.IDX	TSX COMPOSITE INDEX
TXX.IDX	CBOE TECHNOLOGY INDEX
TYX.IDX	30-YEAR TREASURY BOND
UNCA.IDX	AMEX UNCHANGED
UNCD.IDX	OTC UNCHANGED
UNCE.IDX	ETFS  Unchanged Stocks
UNCN.IDX	NYSE Unchanged Volume
UNCQ.IDX	NASD UNCHANGED
UOI.IDX	US OIL IOPV
UTY.IDX	Phlx Utility Index
UUO.IDX	The Select Utility Index
UVCA.IDX	AMEX UNCHANGED VOLUME
UVCD.IDX	OTC UNCHANGED VOLUME
UVCE.IDX	ETFS  Unchanged Volume
UVCN.IDX	NYSE UNCHANGED VOLUME
UVCQ.IDX	NASD UNCHANGED VOLUME
VFWA.IDX	VOL Index First Forward Implied Volatility
VFWB.IDX	VOL Index Second Forward Implied Volatility
VFY.IDX	MINI BIOTECHNOLOGY INDEX
VGH.IDX	MINI PHARMACEUTICAL INDEX
VIO.IDX	CBOE OIL INDEX REDUCED LEAP 199
VIX.IDX	CBOE Volatility Index
VJW.IDX	MINI SECURITIES BROKER DEALER IN
VLA.IDX	VALUE LINE INDEX
VLG.IDX	VALUE LINE GEOMETRIC
VVOL.IDX	VOL Index Average Forward Implied Volatility
VWA.IDX	CBOE MARKET VOLATILITY -SPX ASK
VWB.IDX	CBOE MARKET VOLATILITY -SPX BID
VXB.IDX	JUMBO CBOE VOLATILITY INDEX
VXD.IDX	CBOE DJIA VOLATILITY INDEX
VXDE.IDX	DEC CBOE VOLATILITY INDEX
VXH.IDX	MORGAN STANLEY HEALTHCARE PROVI
VXJU.IDX	JUN CBOE VOLATILITY INDEX
VXMA.IDX	MAR CBOE VOLATILITY INDEX
VXN.IDX	CBOE NASDAQ Volatility Index
VXO.IDX	CBOE OEX VOLATILITY INDEX
VXP.IDX	MORGAN STANLEY HEALTHCARE PRODU
VXSE.IDX	SEP CBOE VOLATILITY INDEX
VXV.IDX	CBOE S&P 500 3M VOLATILITY INDEX
WMX.IDX	ISE WALMART SUPLR INDEX
XAH.IDX	Internet Architecture Holders
XAL.IDX	AMEX Airline Index
XAO.IDX	ASX All Ordinaries
XAU.IDX	Phlx Gold Silver Index
XAX.IDX	AMEX Composite Index
XBD.IDX	AMEX Securities Broker Dealer
XBEL.IDX	Brussels BEL 20
XBS.IDX	AMEX SECURITIES BROKER/DEALER I
XCI.IDX	AMEX Computers Index
XDH.IDX	Broadband Holders Index
XEO.IDX	S& P 100 INDEX[EUROPEAN    STYLE
XEX.IDX	Phlx Europe Sector Index
XFI.IDX	AMEX Financial Subr Index
XHL.IDX	AMEX Healthcare Sub Index
XIBX.IDX	IBEX 35
XID.IDX	AMEX Industrial Sub Index
XII.IDX	AMEX Institutional Index
XIT.IDX	AMEX Information Techonlogies Sub Index
XJO.IDX	S&P/ASX 200
XKH.IDX	Market 2000 Holders Index
XMI.IDX	AMEX Major Market Index
XNA.IDX	AMEX Natural Resources Sub Index
XNG.IDX	AMEX Natural Gas Index
XOI.IDX	AMEX Oil Index
XPT.IDX	FT IPOX 100 IOPV
XRH.IDX	Regional Bank Holders Index
XSH.IDX	Semiconductor Holders Index
XSP.IDX	S& P 500 MINI-SPX OPTIO    IND
XST.IDX	The Select Ten Index
XSV.IDX	AMEX ITITUTIONAL INDEX OPEN S
XTC.IDX	AMEX North Ameican Telecom Index
XTV.IDX	NORTH AMERICAN TELECOMMUNICATIO
XUH.IDX	Utilities Holders Index
XUO.IDX	CLAYMORE ZACKS SEC IOPV
XWH.IDX	Software Holders Index
YIH.IDX	Internet Infrastructure Holders
ZAX.IDX	ZACKS MICRO CAP INDEX
ZIO.IDX	CBOE OIL INDEX REDUCED 10% LEAP
ZOC.IDX	CBOE TECHNOLOGY INDEX REDUCED L
ZWI.IDX	PALISADES WATER INDEX
