Symbol	Description
AAC	Australia Acquisition Corp.
AACC	Asset Acceptance Capital Corp.
AACOU	Australia Acquisition Corp.
AACOW	Australia Acquisition Corp.
AAME	Atlantic American Corporation
AAON	AAON Inc.
AAPL	Apple Inc.
AATI	Advanced Analogic Technologies Inc.
AAWW	Atlas Air Worldwide Holdings
AAXJ	iShares MSCI All Country Asia ex Japan Index Fund
ABAT	Advanced Battery Technologies Inc.
ABAX	ABAXIS Inc.
ABBC	Abington Bancorp Inc.
ABCB	Ameris Bancorp
ABCD	Cambium Learning Group Inc.
ABCO	The Advisory Board Company
ABCW	Anchor BanCorp Wisconsin Inc.
ABFS	Arkansas Best Corporation
ABIO	Arca Biopharma Inc.
ABMD	ABIOMED Inc.
ABTL	Autobytel Inc.
ABVA	Alliance Bankshares Corporation
ACAD	ACADIA Pharmaceuticals Inc.
ACAS	American Capital Ltd.
ACAT	Arctic Cat Inc.
ACCL	Accelrys Inc.
ACET	Aceto Corporation
ACFCD	Atlantic Coast Federal Corporation
ACFN	Acorn Energy Inc.
ACGL	Arch Capital Group Ltd.
ACHN	Achillion Pharmaceuticals Inc.
ACIW	ACI Worldwide Inc.
ACLS	Axcelis Technologies Inc.
ACMR	A.C. Moore Arts & Crafts Inc.
ACNB	ACNB Corporation
ACOM	Ancestry.com Inc.
ACOR	Acorda Therapeutics Inc.
ACPW	Active Power Inc.
ACRX	AcelRx Pharmaceuticals Inc.
ACTG	Acacia Research Corporation
ACTS	Actions Semiconductor Co. Ltd.
ACUR	Acura Pharmaceuticals Inc.
ACWI	iShares MSCI ACWI Index Fund
ACWX	iShares MSCI ACWI ex US Index Fund
ACXM	Acxiom Corporation
ADAM	A.D.A.M. Inc.
ADAT	Authentidate Holding Corp.
ADBE	Adobe Systems Incorporated
ADEP	Adept Technology Inc.
ADES	ADA-ES Inc.
ADGF	Adams Golf Inc.
ADLR	Adolor Corporation
ADP	Automatic Data Processing Inc.
ADPI	American Dental Partners Inc.
ADRA	BLDRS Asia 50 ADR Index Fund
ADRD	BLDRS Developed Markets 100 ADR Index Fund
ADRE	BLDRS Emerging Markets 50 ADR Index Fund
ADRU	BLDRS Europe 100 ADR Index Fund
ADSK	Autodesk Inc.
ADTN	ADTRAN Inc.
ADUS	Addus HomeCare Corporation
ADVS	Advent Software Inc.
AEGR	Aegerion Pharmaceuticals Inc.
AEHR	Aehr Test Systems
AEIS	Advanced Energy Industries Inc.
AEPI	AEP Industries Inc.
AERG	Applied Energetics Inc
AERL	Asia Entertainment & Resources Ltd
AETI	American Electric Technologies Inc.
AEY	ADDvantage Technologies Group Inc.
AEZS	AEterna Zentaris Inc.
AFAM	Almost Family Inc
AFCB	Athens Bancshares Corporation
AFCE	AFC Enterprises Inc.
AFFM	Affirmative Insurance Holdings Inc.
AFFX	Affymetrix Inc.
AFFY	Affymax Inc.
AFOP	Alliance Fiber Optic Products Inc.
AFSI	AmTrust Financial Services Inc.
AGEN	Agenus Inc.
AGII	Argo Group International Holdings Ltd.
AGNC	American Capital Agency Corp.
AGYS	Agilysys Inc.
AHCI	Allied HealthCare International Inc.
AHGP	Alliance Holdings GP L.P.
AHII	Animal Health International Inc.
AHPI	Allied Healthcare Products Inc.
AIMC	Altra Holdings Inc.
AINV	Apollo Investment Corporation
AIRM	Air Methods Corporation
AIRT	Air T Inc.
AIXG	Aixtron SE
AKAM	Akamai Technologies Inc.
AKRX	Akorn Inc.
ALAN	Alanco Technologies Inc.
ALCO	Alico Inc.
ALGN	Align Technology Inc.
ALGT	Allegiant Travel Company
ALIM	Alimera Sciences Inc.
ALKS	Alkermes Inc.
ALLB	Alliance Bancorp Inc. of Pennsylvania
ALLBD	Alliance Bancorp Inc. of Pennsylvania
ALLT	Allot Communications Ltd.
ALNC	Alliance Financial Corporation
ALNY	Alnylam Pharmaceuticals Inc.
ALOG	Analogic Corporation
ALOT	Astro-Med Inc.
ALRN	American Learning Corporation
ALSK	Alaska Communications Systems Group Inc.
ALTE	Alterra Capital Holdings Ltd
ALTH	Allos Therapeutics Inc.
ALTI	Altair Nanotechnologies Inc.
ALTR	Altera Corporation
ALVR	Alvarion Ltd.
ALXA	Alexza Pharmaceuticals Inc.
ALXN	Alexion Pharmaceuticals Inc.
AMAC	American Medical Alert Corp.
AMAG	AMAG Pharmaceuticals Inc.
AMAP	AutoNavi Holdings Limited
AMAT	Applied Materials Inc.
AMCC	Applied Micro Circuits Corporation
AMCF	Andatee China Marine Fuel Services Corporation
AMCN	AirMedia Group Inc
AMED	Amedisys Inc
AMGN	Amgen Inc.
AMIC	American Independence Corp.
AMIE	Ambassadors International Inc.
AMKR	Amkor Technology Inc.
AMLN	Amylin Pharmaceuticals Inc.
AMMD	American Medical Systems Holdings Inc.
AMNB	American National Bankshares Inc.
AMOT	Allied Motion Technologies Inc.
AMOV	America Movil S.A.B. de C.V.
AMPL	Ampal-American Israel Corporation
AMRB	American River Bankshares
AMRI	Albany Molecular Research Inc.
AMRN	Amarin Corporation PLC
AMRS	Amyris Inc.
AMSC	American Superconductor Corporation
AMSF	AMERISAFE Inc.
AMSG	Amsurg Corp.
AMSWA	American Software Inc.
AMTC	Ameritrans Capital Corporation
AMTCP	Ameritrans Capital Corporation
AMTD	TD Ameritrade Holding Corporation
AMWD	American Woodmark Corporation
AMZN	Amazon.com Inc.
ANAC	Anacor Pharmaceuticals Inc.
ANAD	ANADIGICS Inc.
ANAT	American National Insurance Company
ANCB	Anchor Bancorp
ANCI	American Caresource Holdings Inc
ANCX	Access National Corporation
ANDE	The Andersons Inc.
ANDS	Anadys Pharmaceuticals Inc.
ANEN	Anaren Inc.
ANGN	Angeion Corporation
ANGO	AngioDynamics Inc.
ANIK	Anika Therapeutics Inc.
ANLY	Analysts International Corporation
ANNB	Annapolis Bancorp Inc.
ANSS	ANSYS Inc.
ANSW	Answers Corporation
ANTH	Anthera Pharmaceuticals Inc.
ANTP	PHAZAR CORP
AONE	A123 Systems Inc.
AOSL	Alpha and Omega Semiconductor Limited
APAC	APAC Customer Services Inc.
APAGF	Apco Oil and Gas International Inc.
APCVZ	Fresenius Kabi Pharmaceuticals Holding Inc.
APEI	American Public Education Inc.
APFC	American Pacific Corporation
APKT	Acme Packet Inc.
APOG	Apogee Enterprises Inc.
APOL	Apollo Group Inc.
APPA	A.P. Pharma Inc.
APPY	AspenBio Pharma Inc.
APRI	Apricus Biosciences Inc
APSA	Alto Palermo S.A.
APWR	A-Power Energy Generation Systems Ltd.
ARAY	Accuray Incorporated
ARBA	Ariba Inc.
ARBX	Arbinet Corporation
ARCC	Ares Capital Corporation
ARCI	Appliance Recycling Centers of America Inc.
ARCL	Archipelago Learning Inc.
ARCW	Arc Wireless Solutions Inc.
ARDNA	Arden Group Inc.
AREX	Approach Resources Inc.
ARGN	Amerigon Incorporated
ARIA	ARIAD Pharmaceuticals Inc.
ARII	American Railcar Industries Inc.
ARKR	Ark Restaurants Corp.
ARLP	Alliance Resource Partners L.P.
ARMH	ARM Holdings plc
ARNA	Arena Pharmaceuticals Inc.
AROW	Arrow Financial Corporation
ARQL	ArQule Inc.
ARRS	Arris Group Inc
ARRY	Array BioPharma Inc.
ARSD	Arabian American Development Company
ARTC	ArthroCare Corporation
ARTNA	Artesian Resources Corporation
ARTW	Art's-Way Manufacturing Co. Inc.
ARTX	Arotech Corporation
ARUN	Aruba Networks Inc.
ARWR	Arrowhead Research Corporation
ARYX	ARYx Therapeutics Inc.
ASBC	Associated Banc-Corp
ASBI	Ameriana Bancorp
ASCA	Ameristar Casinos Inc.
ASCMA	Ascent Media Corporation
ASEI	American Science and Engineering Inc.
ASFI	Asta Funding Inc.
ASGN	On Assignment Inc.
ASGR	America Service Group Inc.
ASIA	AsiaInfo-Linkage Inc.
ASMI	ASM International N.V.
ASML	ASML Holding N.V.
ASNA	Ascena Retail Group Inc.
ASPS	Altisource Portfolio Solutions S.A.
ASRV	AmeriServ Financial Inc.
ASRVP	AmeriServ Financial Inc.
ASTC	Astrotech Corporation
ASTE	Astec Industries Inc.
ASTI	Ascent Solar Technologies Inc.
ASTIZ	Ascent Solar Technologies Inc.
ASTM	Aastrom Biosciences Inc.
ASUR	Asure Software Inc
ASYS	Amtech Systems Inc.
ATAI	ATA Inc.
ATAX	America First Tax Exempt Investors L.P.
ATEA	Astea International Inc.
ATEC	Alphatec Holdings Inc.
ATHN	athenahealth Inc.
ATHR	Atheros Communications Inc.
ATHX	Athersys Inc.
ATLO	Ames National Corporation
ATLS	Atlas Energy Inc.
ATMI	ATMI Inc.
ATML	Atmel Corporation
ATNI	Atlantic Tele-Network Inc.
ATPG	ATP Oil & Gas Corporation
ATRC	AtriCure Inc.
ATRI	ATRION Corporation
ATRM	Aetrium Incorporated
ATRN	Atrinsic Inc.
ATRO	Astronics Corporation
ATSG	Air Transport Services Group Inc
ATVI	Activision Blizzard Inc
ATX	Cross (A.T.) Company
AUBN	Auburn National Bancorporation Inc.
AUDC	AudioCodes Ltd.
AUTC	AutoChina International Limited
AUTH	AuthenTec Inc.
AUXL	Auxilium Pharmaceuticals Inc.
AVAV	AeroVironment Inc.
AVCA	Advocat Inc.
AVEO	AVEO Pharmaceuticals Inc.
AVGO	Avago Technologies Limited
AVID	Avid Technology Inc.
AVII	AVI BioPharma Inc.
AVNR	Avanir Pharmaceuticals Inc
AVNW	Aviat Networks Inc.
AVTR	Avatar Holdings Inc.
AWRE	Aware Inc.
AXAS	Abraxas Petroleum Corporation
AXFN	iShares MSCI ACWI ex US Financials Sector Index Fund
AXTI	AXT Inc
AZPN	Aspen Technology Inc.
BABY	Natus Medical Incorporated
BAGL	Einstein Noah Restaurant Group Inc.
BAMM	Books-A-Million Inc.
BANF	BancFirst Corporation
BANFP	BancFirst Corporation
BANR	Banner Corporation
BARI	Bancorp Rhode Island Inc.
BASI	Bioanalytical Systems Inc.
BBBB	Blackboard Inc.
BBBY	Bed Bath & Beyond Inc.
BBEP	BreitBurn Energy Partners L.P.
BBGI	Beasley Broadcast Group Inc.
BBND	BigBand Networks Inc.
BBNK	Bridge Capital Holdings
BBOX	Black Box Corporation
BBRG	Bravo Brio Restaurant Group Inc.
BBSI	Barrett Business Services Inc.
BBXT	BankAtlantic Bancorp Inc.
BCAR	Bank of the Carolinas Corporation
BCBP	BCB Bancorp Inc. (NJ)
BCDS	BCD Semiconductor Manufacturing Limited
BCOM	B Communications Ltd.
BCON	Beacon Power Corporation
BCOND	Beacon Power Corporation
BCPC	Balchem Corporation
BCRX	BioCryst Pharmaceuticals Inc.
BCSB	BCSB Bancorp Inc.
BCSI	Blue Coat Systems Inc
BDCO	Blue Dolphin Energy Company
BDE	Black Diamond Inc.
BDGE	Bridge Bancorp Inc.
BDMS	Birner Dental Management Services Inc.
BDSI	BioDelivery Sciences International Inc.
BEAT	CardioNet Inc.
BEAV	BE Aerospace Inc.
BEBE	bebe stores inc.
BECN	Beacon Roofing Supply Inc.
BELFA	Bel Fuse Inc.
BELFB	Bel Fuse Inc.
BERK	Berkshire Bancorp Inc.
BEST	Shiner International Inc.
BEXP	Brigham Exploration Company
BFED	Beacon Federal Bancorp Inc.
BFIN	BankFinancial Corporation
BFLY	Bluefly Inc.
BFSB	Brooklyn Federal Bancorp Inc.
BGCP	BGC Partners Inc.
BGFV	Big 5 Sporting Goods Corporation
BGMD	BG Medicine Inc.
BHLB	Berkshire Hills Bancorp Inc.
BIB	ProShares Trust ProShares Ultra Nasdaq Biotechnology
BICK	First Trust Exchange-Traded Fund II First Trust BICK Index Fund
BIDU	Baidu Inc.
BIDZ	Bidz.com Inc.
BIIB	Biogen Idec Inc
BIOC	BioClinica Inc
BIOD	Biodel Inc.
BIOF	BioFuel Energy Corp.
BIOS	BioScrip Inc.
BIRT	Actuate Corporation
BIS	ProShares Trust ProShares UltraShort Nasdaq Biotechnology
BITS	Bitstream Inc.
BJGP	BMP Sunstone Corporation
BJRI	BJ's Restaurants Inc.
BKBK	Britton & Koontz Capital Corporation
BKCC	BlackRock Kelso Capital Corporation
BKMU	Bank Mutual Corporation
BKOR	Oak Ridge Financial Services Inc.
BKSC	Bank of South Carolina Corp.
BKYF	The Bank of Kentucky Financial Corp.
BLDP	Ballard Power Systems Inc.
BLDR	Builders FirstSource Inc.
BLIN	Bridgeline Digital Inc.
BLKB	Blackbaud Inc.
BLTI	BioLase Technology Inc.
BLUD	Immucor Inc.
BMC	BMC Software Inc.
BMRC	Bank of Marin Bancorp
BMRN	BioMarin Pharmaceutical Inc.
BMTC	Bryn Mawr Bank Corporation
BMTI	BioMimetic Therapeutics Inc.
BNCL	Beneficial Mutual Bancorp Inc.
BNCN	BNC Bancorp
BNHN	Benihana Inc.
BNHNA	Benihana Inc.
BNSO	Bonso Electronics International Inc.
BNVI	Bionovo Inc.
BOBE	Bob Evans Farms Inc.
BOCH	Bank of Commerce Holdings (CA)
BODY	Body Central Corp.
BOFI	BofI Holding Inc.
BOKF	BOK Financial Corporation
BOLT	Bolt Technology Corporation
BONA	Bona Film Group Limited
BONT	The Bon-Ton Stores Inc.
BOOM	Dynamic Materials Corporation
BOOT	LaCrosse Footwear Inc.
BOSC	B.O.S. Better Online Solutions
BOVA	Bank Of Virginia
BPAX	Biosante Pharmaceuticals Inc.
BPFH	Boston Private Financial Holdings Inc.
BPFHW	Boston Private Financial Holdings Inc.
BPHX	BluePhoenix Solutions Ltd.
BPOP	Popular Inc.
BPOPM	Popular Inc.
BPOPN	Popular Inc.
BRCD	Brocade Communications Systems Inc.
BRCM	Broadcom Corporation
BRID	Bridgford Foods Corporation
BRKL	Brookline Bancorp Inc.
BRKR	Bruker Corporation
BRKS	Brooks Automation Inc.
BRLI	Bio-Reference Laboratories Inc.
BRNC	Bronco Drilling Company Inc.
BSDM	BSD Medical Corporation
BSET	Bassett Furniture Industries Incorporated
BSFT	BroadSoft Inc.
BSPM	Biostar Pharmaceuticals Inc.
BSQR	BSQUARE Corporation
BSRR	Sierra Bancorp
BSTC	BioSpecifics Technologies Corp
BTFG	BancTrust Financial Group Inc.
BTUI	BTU International Inc.
BUCY	Bucyrus International Inc.
BUSE	First Busey Corporation
BVSN	BroadVision Inc.
BWEN	Broadwind Energy Inc.
BWINA	Baldwin & Lyons Inc.
BWINB	Baldwin & Lyons Inc.
BWLD	Buffalo Wild Wings Inc.
BWOW	Wowjoint Holdings Limited
BWOWU	Wowjoint Holdings Limited
BWOWW	Wowjoint Holdings Limited
BYFC	Broadway Financial Corporation
CA	CA Inc.
CAAS	China Automotive Systems Inc.
CABL	China Cablecom Holdings Ltd.
CAC	Camden National Corporation
CACB	Cascade Bancorp
CACC	Credit Acceptance Corporation
CACH	Cache Inc.
CADC	China Advanced Construction Materials Group Inc.
CADE	Cadence Financial Corporation
CADX	Cadence Pharmaceuticals Inc.
CAEI	China Architectural Engineering Inc
CAFI	Camco Financial Corporation
CAGC	China Agritech Inc.
CAKE	The Cheesecake Factory Incorporated
CALD	Callidus Software Inc.
CALI	China Auto Logistics Inc.
CALL	VocalTec Communications Ltd.
CALM	Cal-Maine Foods Inc.
CALP	Caliper Life Sciences Inc
CALPW	Caliper Life Sciences Inc
CAMP	CalAmp Corp.
CAMT	Camtek Ltd.
CAPS	Capstone Therapeutics Corp
CAR	Avis Budget Group Inc.
CART	Carolina Trust Bank
CARV	Carver Bancorp Inc.
CASB	Cascade Financial Corp.
CASH	Meta Financial Group Inc.
CASM	CAS Medical Systems Inc.
CASS	Cass Information Systems Inc
CAST	ChinaCast Education Corporation
CASY	Caseys General Stores Inc.
CATM	Cardtronics Inc.
CATY	Cathay General Bancorp
CAVM	Cavium Networks Inc.
CAVO	Cavico Corp.
CAZA	Cazador Acquisition Corporation Ltd.
CAZAU	Cazador Acquisition Corporation Ltd.
CAZAW	Cazador Acquisition Corporation Ltd.
CBAK	China BAK Battery Inc.
CBAN	Colony Bankcorp Inc.
CBEH	China Integrated Energy Inc
CBEY	Cbeyond Inc.
CBIN	Community Bank Shares of Indiana Inc.
CBKN	Capital Bank Corporation
CBLI	Cleveland BioLabs Inc.
CBMX	CombiMatrix Corporation
CBMXW	CombiMatrix Corporation
CBNJ	Cape Bancorp Inc.
CBNK	Chicopee Bancorp Inc.
CBOE	CBOE Holdings Inc.
CBOU	Caribou Coffee Company Inc.
CBPO	China Biologic Products Inc.
CBRL	Cracker Barrel Old Country Store Inc.
CBRX	Columbia Laboratories Inc.
CBSH	Commerce Bancshares Inc.
CBST	Cubist Pharmaceuticals Inc.
CCBD	Community Central Bank Corp.
CCBG	Capital City Bank Group
CCCL	China Ceramics Co. Ltd.
CCCLU	China Ceramics Co. Ltd.
CCCLW	China Ceramics Co. Ltd.
CCIH	ChinaCache International Holdings Ltd.
CCIX	Coleman Cable Inc.
CCME	China MediaExpress Holdings Inc.
CCMP	Cabot Microelectronics Corporation
CCNE	CNB Financial Corporation
CCOI	Cogent Communications Group Inc.
CCRN	Cross Country Healthcare Inc.
CCRT	CompuCredit Holdings Corporation
CCUR	Concurrent Computer Corporation
CDCS	CDC Software Corporation
CDII	China Direct Industries Inc.
CDNS	Cadence Design Systems Inc.
CDTI	Clean Diesel Technologies Inc.
CDXS	Codexis Inc.
CDZI	Cadiz Inc.
CEBK	Central Bancorp Inc
CECE	CECO Environmental Corp.
CECO	Career Education Corporation
CEDC	Central European Distribution Corporation
CEDU	ChinaEdu Corporation
CELG	Celgene Corporation
CELGZ	Celgene Corporation
CELL	Brightpoint Inc.
CELM	China Electric Motor Inc.
CENT	Central Garden & Pet Company
CENTA	Central Garden & Pet Company
CENX	Century Aluminum Company
CEPH	Cephalon Inc.
CERN	Cerner Corporation
CERP	Cereplast Inc.
CERS	Cerus Corporation
CETV	Central European Media Enterprises Ltd.
CEVA	CEVA Inc.
CFBK	Central Federal Corporation
CFFC	Community Financial Corp.
CFFI	C&F Financial Corporation
CFFN	Capitol Federal Financial
CFK	CE Franklin Ltd.
CFNB	California First National Bancorp
CFNL	Cardinal Financial Corporation
CFSG	China Fire & Security Group Inc.
CGEN	Compugen Ltd.
CGNX	Cognex Corporation
CHBT	China-Biotics Inc.
CHCI	Comstock Homebuilding Companies Inc.
CHCO	City Holding Company
CHDN	Churchill Downs Incorporated
CHDX	Chindex International Inc.
CHEV	Cheviot Financial Corp
CHFC	Chemical Financial Corporation
CHFN	Charter Financial Corp.
CHINA	CDC Corporation
CHKE	Cherokee Inc.
CHKP	Check Point Software Technologies Ltd.
CHLN	China Housing & Land Development Inc.
CHMP	Champion Industries Inc.
CHNG	China Natural Gas Inc.
CHNR	China Natural Resources Inc.
CHOP	China Gerui Advanced Materials Group Limited
CHOPW	China Gerui Advanced Materials Group Limited
CHRM	Charm Communications Inc.
CHRS	Charming Shoppes Inc.
CHRW	C.H. Robinson Worldwide Inc.
CHSCP	CHS Inc
CHSI	Catalyst Health Solutions Inc
CHTP	Chelsea Therapeutics International Ltd.
CHTR	Charter Communications Inc.
CHUX	O'Charley's Inc.
CHYR	Chyron Corporation
CIDM	Cinedigm Digital Cinema Corp
CIEN	CIENA Corporation
CIGX	Star Scientific Inc.
CIIC	China Infrastructure Investment Corporation
CIMT	Cimatron Limited
CINF	Cincinnati Financial Corporation
CISG	CNinsure Inc.
CITZ	CFS Bancorp Inc.
CIZN	Citizens Holding Company
CJJD	China Jo-Jo Drugstores Inc.
CKEC	Carmike Cinemas Inc.
CKSW	ClickSoftware Technologies Ltd.
CKXE	CKX Inc.
CLBH	Carolina Bank Holdings Inc.
CLCT	Collectors Universe Inc.
CLDA	Clinical Data Inc.
CLDX	Celldex Therapeutics Inc
CLFC	Center Financial Corporation
CLFD	Clearfield Inc.
CLMS	Calamos Asset Management Inc.
CLMT	Calumet Specialty Products Partners L.P.
CLNE	Clean Energy Fuels Corp.
CLRO	ClearOne Communications Inc.
CLSN	Celsion Corporation
CLUB	Town Sports International Holdings Inc.
CLWR	Clearwire Corporation
CLWT	Euro Tech Holdings Company Limited
CMCO	Columbus McKinnon Corporation
CMCSA	Comcast Corporation
CMCSK	Comcast Corporation
CME	CME Group Inc.
CMED	China Medical Technologies Inc.
CMFB	COMMERCEFIRST BANCORP INC
CMLS	Cumulus Media Inc.
CMRG	Casual Male Retail Group Inc.
CMSB	CMS Bancorp Inc.
CMTL	Comtech Telecommunications Corp.
CNAF	Commercial National Financial Corporation
CNBC	Center Bancorp Inc.
CNBKA	Century Bancorp Inc.
CNET	ChinaNet Online Holdings Inc.
CNIT	China Information Technology Inc.
CNMD	CONMED Corporation
CNQR	Concur Technologies Inc.
CNSL	Consolidated Communications Holdings Inc.
CNTF	China TechFaith Wireless Communication Technology Limited
CNTY	Century Casinos Inc.
CNVO	Convio Inc.
CNXT	Conexant Systems Inc.
CNYD	China Yida Holding Co.
COBK	Colonial Financial Services Inc.
COBR	Cobra Electronics Corporation
COBZ	CoBiz Financial Inc.
COCO	Corinthian Colleges Inc.
COGO	Cogo Group Inc.
COHR	Coherent Inc.
COHU	Cohu Inc.
COIN	Converted Organics Inc.
COINW	Converted Organics Inc.
COINZ	Converted Organics Inc.
COKE	Coca-Cola Bottling Co. Consolidated
COLB	Columbia Banking System Inc.
COLM	Columbia Sportswear Company
COMV	Comverge Inc.
CONN	Conn's Inc.
COOL	Majesco Entertainment Company
CORE	Core-Mark Holding Company Inc.
CORT	Corcept Therapeutics Incorporated
COSI	Cosi Inc.
COST	Costco Wholesale Corporation
COWN	Cowen Group Inc.
CPBC	Community Partners Bancorp
CPBK	Community Capital Corporation
CPEX	CPEX Pharmaceuticals Inc.
CPGI	China Shengda Packaging Group Inc.
CPHC	Canterbury Park Holding Corporation
CPHD	CEPHEID
CPII	CPI International Inc.
CPIX	Cumberland Pharmaceuticals Inc.
CPKI	California Pizza Kitchen Inc.
CPLA	Capella Education Company
CPLP	Capital Product Partners L.P.
CPNO	Copano Energy L.L.C.
CPRT	Copart Inc.
CPRX	Catalyst Pharmaceutical Partners Inc.
CPSI	Computer Programs and Systems Inc.
CPSL	China Precision Steel Inc.
CPSS	Consumer Portfolio Services Inc.
CPST	Capstone Turbine Corporation
CPTS	Conceptus Inc.
CPWM	Cost Plus Inc.
CPWR	Compuware Corporation
CRA	Celera Corporation
CRAI	CRA InternationalInc.
CRAY	Cray Inc
CRBC	Citizens Republic Bancorp Inc.
CRDC	Cardica Inc.
CRDN	Ceradyne Inc.
CRED	Credo Petroleum Corporation
CREE	Cree Inc.
CREG	China Recycling Energy Corporation
CRESW	Cresud S.A.C.I.F. y A.
CRESY	Cresud S.A.C.I.F. y A.
CRFN	Crescent Financial Corporation
CRIC	China Real Estate Information Corporation
CRIS	Curis Inc.
CRME	Cardiome Pharma Corporation
CRMT	America's Car-Mart Inc.
CRNT	Ceragon Networks Ltd.
CROX	Crocs Inc.
CRRB	Carrollton Bancorp
CRRC	Courier Corporation
CRTP	China Ritar Power Corp.
CRTX	Cornerstone Therapeutics Inc.
CRUS	Cirrus Logic Inc.
CRVL	CorVel Corp.
CRWN	Crown Media Holdings Inc.
CRWS	Crown Crafts Inc.
CRXL	Crucell NV
CRYP	CryptoLogic Limited
CRZO	Carrizo Oil & Gas Inc.
CSBC	Citizens South Banking Corporation
CSBK	Clifton Savings Bancorp Inc.
CSCD	Cascade Microtech Inc.
CSCO	Cisco Systems Inc.
CSFL	CenterState Banks Inc.
CSGP	CoStar Group Inc.
CSGS	CSG Systems International Inc.
CSII	Cardiovascular Systems Inc.
CSIQ	Canadian Solar Inc.
CSKI	China Sky One Medical Inc.
CSPI	CSP Inc.
CSTR	Coinstar Inc.
CSUN	China Sunergy Co. Ltd.
CSWC	Capital Southwest Corporation
CTAS	Cintas Corporation
CTBC	The Connecticut Bank and Trust Company
CTBI	Community Trust Bancorp Inc.
CTCH	Commtouch Software Ltd.
CTCM	CTC Media Inc.
CTCT	Constant Contact Inc.
CTDC	China Technology Development Group Corporation
CTE	SinoTech Energy Limited
CTEK	CleanTech Innovations Inc.
CTEL	City Telecom (H.K.) Limited
CTFO	China TransInfo Technology Corp.
CTGX	Computer Task Group Incorporated
CTHR	Charles & Colvard Ltd
CTIB	CTI Industries Corporation
CTIC	Cell Therapeutics Inc.
CTRN	Citi Trends Inc.
CTRP	Ctrip.com International Ltd.
CTSH	Cognizant Technology Solutions Corporation
CTWS	Connecticut Water Service Inc.
CTXS	Citrix Systems Inc.
CU	First Trust Exchange-Traded Fund II First Trust ISE Global Copper Index Fund
CUBA	The Herzfeld Caribbean Basin Fund Inc.
CUTR	Cutera Inc.
CVBF	CVB Financial Corporation
CVBK	Central Virginia Bankshares Inc.
CVCO	Cavco Industries Inc.
CVCY	Central Valley Community Bancorp
CVGI	Commercial Vehicle Group Inc.
CVGW	Calavo Growers Inc.
CVLT	CommVault Systems Inc.
CVLY	Codorus Valley Bancorp Inc
CVTI	Covenant Transportation Group Inc.
CVV	CVD Equipment Corporation
CVVT	China Valves Technology Inc.
CWBC	Community West Bancshares
CWBS	Commonwealth Bankshares Inc.
CWCO	Consolidated Water Co. Ltd.
CWEI	Clayton Williams Energy Inc.
CWS	China Wind Systems Inc.
CWST	Casella Waste Systems Inc.
CWTR	Coldwater Creek Inc.
CXDC	China XD Plastics Company Limited
CXPO	Crimson Exploration Inc.
CY	Cypress Semiconductor Corporation
CYAN	Cyanotech Corporation
CYBE	CyberOptics Corporation
CYBI	Cybex International Inc.
CYBX	Cyberonics Inc.
CYCC	Cyclacel Pharmaceuticals Inc.
CYCCP	Cyclacel Pharmaceuticals Inc.
CYDE	CyberDefender Corporation
CYMI	Cymer Inc.
CYNO	Cynosure Inc.
CYOU	Changyou.com Limited
CYTK	Cytokinetics Incorporated
CYTR	CytRx Corporation
CYTX	Cytori Therapeutics Inc
CYTXW	Cytori Therapeutics Inc
CZFC	Citizens First Corporation
CZNC	Citizens & Northern Corp
CZWI	Citizens Community Bancorp Inc.
DAIO	Data I/O Corporation
DAKT	Daktronics Inc.
DARA	DARA Biosciences Inc.
DAVE	Famous Dave's of America Inc.
DBLE	Double Eagle Petroleum Company
DBLEP	Double Eagle Petroleum Company
DCIX	Diana Containerships Inc.
DCOM	Dime Community Bancshares Inc.
DCTH	Delcath Systems Inc.
DDIC	DDi Corp.
DDMX	Dynamex Inc.
DDSS	Labopharm Inc.
DEAR	Dearborn Bancorp Inc.
DECK	Deckers Outdoor Corporation
DEER	Deer Consumer Products Inc.
DELL	Dell Inc.
DENN	Denny's Corporation
DEPO	DepoMed Inc.
DEST	Destination Maternity Corporation
DFR	Deerfield Capital Corp.
DFZ	R.G. Barry Corporation
DGAS	Delta Natural Gas Company Inc.
DGICA	Donegal Group Inc.
DGICB	Donegal Group Inc.
DGII	Digi International Inc.
DGIT	DG FastChannel Inc.
DGLY	Digital Ally Inc.
DHFT	Diamond Hill Financial Trends Fund Inc.
DHIL	Diamond Hill Investment Group Inc.
DHRM	Dehaier Medical Systems Limited
DIET	eDiets.com Inc.
DIOD	Diodes Incorporated
DISCA	Discovery Communications Inc
DISCB	Discovery Communications Inc
DISCK	Discovery Communications Inc
DISH	DISH Network Corporation
DITC	Ditech Networks Inc.
DJCO	Daily Journal Corp. (S.C.)
DJSP	DJSP Enterprises Inc
DJSPU	DJSP Enterprises Inc
DJSPW	DJSP Enterprises Inc
DLGC	Dialogic Inc.
DLIA	dELIA*s Inc.
DLLR	Dollar Financial Corp.
DLTR	Dollar Tree Inc.
DMAN	DemandTec Inc.
DMED	D. Medical Industries Ltd.
DMLP	Dorchester Minerals L.P.
DMND	Diamond Foods Inc.
DMRC	Digimarc Corporation
DNBF	Dnb Financial Corp
DNBK	Danvers Bancorp Inc.
DNDN	Dendreon Corporation
DNEX	Dionex Corporation
DORM	Dorman Products Inc.
DOVR	Dover Saddlery Inc.
DPTR	Delta Petroleum Corporation
DRAD	Digirad Corporation
DRAM	Dataram Corporation
DRCO	Dynamics Research Corporation
DRIV	Digital River Inc.
DROOY	DRDGOLD Limited
DRRX	Durect Corporation
DRWI	Dragonwave Inc
DRYS	DryShips Inc.
DSCI	Derma Sciences Inc.
DSCM	drugstore.com inc.
DSCO	Discovery Laboratories Inc.
DSGX	The Descartes Systems Group Inc.
DSPG	DSP Group Inc.
DSTI	DayStar Technologies Inc.
DSWL	Deswell Industries Inc.
DTLK	Datalink Corporation
DTSI	DTS Inc.
DTV	DIRECTV
DUCK	Duckwall-Alco Stores Inc.
DUSA	DUSA Pharmaceuticals Inc.
DVAX	Dynavax Technologies Corporation
DVOX	DynaVox Inc.
DWA	Dreamworks Animation SKG Inc.
DWCH	Datawatch Corporation
DWSN	Dawson Geophysical Company
DXCM	DexCom Inc.
DXPE	DXP Enterprises Inc.
DXYN	The Dixie Group Inc.
DYAX	Dyax Corp.
DYII	Dynacq Healthcare Inc.
DYNT	Dynatronics Corporation
DYSL	Dynasil Corporation of America
EBAY	eBay Inc.
EBIX	Ebix Inc
EBMT	Eagle Bancorp Montana Inc.
EBSB	Meridian Interstate Bancorp Inc.
EBTC	Enterprise Bancorp Inc
EBTX	Encore Bancshares Inc.
ECBE	ECB Bancorp Inc
ECGI	Envoy Capital Group Inc.
ECHO	Echo Global Logistics Inc.
ECOL	US Ecology Inc.
ECPG	Encore Capital Group Inc
ECTY	Ecotality Inc.
ECYT	Endocyte Inc.
EDAC	Edac Technologies Corporation
EDAP	EDAP TMS S.A.
EDGR	EDGAR Online Inc.
EDGW	Edgewater Technology Inc.
EDMC	Education Management Corporation
EDS	Exceed Company Ltd.
EDSWW	Exceed Company Ltd.
EDUC	Educational Development Corporation
EEFT	Euronet Worldwide Inc.
EEI	Ecology and Environment Inc.
EFII	Electronics for Imaging Inc.
EFOI	Energy Focus Inc.
EFSC	Enterprise Financial Services Corporation
EFUT	eFuture Information Technology Inc.
EGBN	Eagle Bancorp Inc.
EGHT	8x8 Inc
EGLE	Eagle Bulk Shipping Inc.
EGOV	NIC Inc.
EHTH	eHealth Inc.
EIHI	Eastern Insurance Holdings Inc.
ELGX	Endologix  Inc
ELMD	Electromed Inc.
ELMG	EMS Technologies Inc.
ELNK	EarthLink Inc.
ELON	Echelon Corporation
ELOS	Syneron Medical Ltd.
ELOY	eLoyalty Corporation
ELRC	Electro Rent Corporation
ELSE	Electro-Sensors Inc.
ELTK	Eltek Ltd.
EMCF	Emclaire Financial Corp
EMCI	EMC Insurance Group Inc.
EMFN	iShares MSCI Emerging Markets Financials Sector Index Fund
EMIF	iShares S&P Emerging Markets Infrastructure Index Fund
EMITF	Elbit Imaging Ltd.
EMKR	EMCORE Corporation
EMMS	Emmis Communications Corporation
EMMSP	Emmis Communications Corporation
EMMT	iShares MSCI Emerging Markets Materials Sector Index Fund
ENDP	Endo Pharmaceuticals Holdings Inc.
ENER	Energy Conversion Devices Inc.
ENG	ENGlobal Corporation
ENMD	EntreMed Inc.
ENOC	EnerNOC Inc.
ENSG	The Ensign Group Inc.
ENTG	Entegris Inc.
ENTR	Entropic Communications Inc.
ENWV	Endwave Corporation
ENZN	Enzon Pharmaceuticals Inc.
EONC	eOn Communications Corporation
EOSPN	EOS Preferred Corporation
EPAX	Ambassadors Group Inc.
EPAY	Bottomline Technologies Inc.
EPCT	EpiCept Corporation
EPHC	Epoch Holding Corporation
EPIC	Epicor Software Corporation
EPIQ	EPIQ Systems Inc.
EPOC	Epocrates Inc.
EQIX	Equinix Inc.
ERES	eResearch Technology Inc.
ERIC	LM Ericsson Telephone Company
ERIE	Erie Indemnity Company
ERII	Energy Recovery Inc.
EROC	Eagle Rock Energy Partners L.P.
EROCW	Eagle Rock Energy Partners L.P.
ERTS	Electronic Arts Inc.
ESBF	ESB Financial Corporation
ESBK	The Elmira Savings Bank FSB
ESCA	Escalade Incorporated
ESEA	Euroseas Ltd.
ESGR	Enstar Group Limited
ESIC	EasyLink Services International Corporation
ESIO	Electro Scientific Industries Inc.
ESLR	Evergreen Solar Inc.
ESLT	Elbit Systems Ltd.
ESMC	Escalon Medical Corp.
ESRX	Express Scripts Inc.
ESSA	ESSA Bancorp Inc.
ESSX	Essex Rental Corporation
ESSXW	Essex Rental Corporation
ESTE	Earthstone Energy Inc.
ESYS	Elecsys Corporation
ETFC	E*TRADE Financial Corporation
ETRM	EnteroMedics Inc.
EUFN	iShares MSCI Europe Financials Sector Index Fund
EURX	Eurand N.V.
EVBS	Eastern Virginia Bankshares Inc.
EVEP	EV Energy Partners L.P.
EVOL	Evolving Systems Inc.
EWBC	East West Bancorp Inc.
EXAC	Exactech Inc.
EXAR	Exar Corporation
EXAS	EXACT Sciences Corporation
EXEL	Exelixis Inc.
EXFO	EXFO Inc
EXLP	Exterran Partners L.P.
EXLS	ExlService Holdings Inc.
EXPD	Expeditors International of Washington Inc.
EXPE	Expedia Inc.
EXPO	Exponent Inc.
EXTR	Extreme Networks Inc.
EXXI	Energy XXI (Bermuda) Limited
EZCH	EZchip Semiconductor Limited
EZPW	EZCORP Inc.
FABK	First Advantage Bancorp
FACE	Physicians Formula Holdings Inc.
FALC	FalconStor Software Inc.
FARM	Farmer Brothers Company
FARO	FARO Technologies Inc.
FAST	Fastenal Company
FBCM	FBR Capital Markets Corporation
FBIZ	First Business Financial Services Inc.
FBMI	Firstbank Corporation
FBMS	The First Bancshares Inc.
FBNC	First Bancorp
FBSI	First Bancshares Inc.
FBSS	Fauquier Bankshares Inc.
FCAL	First California Financial Group Inc.
FCAP	First Capital Inc.
FCBC	First Community Bancshares Inc.
FCCO	First Community Corporation
FCCY	1st Constitution Bancorp (NJ)
FCEL	FuelCell Energy Inc.
FCFC	FirstCity Financial Corporation
FCFL	First Community Bank Corporation of America
FCFS	First Cash Financial Services Inc.
FCHI	iShares FTSE China (HK Listed) Index Fund
FCLF	First Clover Leaf Financial Corp.
FCNCA	First Citizens BancShares Inc.
FCTY	1st Century Bancshares Inc
FCVA	First Capital Bancorp Inc. (VA)
FCZA	First Citizens Banc Corp.
FDEF	First Defiance Financial Corp.
FDML	Federal-Mogul Corporation
FEED	AgFeed Industries Inc.
FEFN	iShares MSCI Far East Financials Sector Index Fund
FEIC	FEI Company
FEIM	Frequency Electronics Inc.
FELE	Franklin Electric Co. Inc.
FFBC	First Financial Bancorp.
FFBCW	First Financial Bancorp.
FFBH	First Federal Bancshares of Arkansas Inc.
FFCH	First Financial Holdings Inc.
FFCO	FedFirst Financial Corporation
FFDF	FFD Financial Corporation
FFEX	Frozen Food Express Industries Inc.
FFFD	North Central Bancshares Inc.
FFHL	Fuwei Films (Holdings) Co. Ltd.
FFHS	First Franklin Corporation
FFIC	Flushing Financial Corporation
FFIN	First Financial Bankshares Inc.
FFIV	F5 Networks Inc.
FFKT	Farmers Capital Bank Corporation
FFKY	First Financial Service Corporation
FFNM	First Federal of Northern Michigan Bancorp Inc.
FFNW	First Financial Northwest Inc.
FHCO	Female Health Company (The)
FIBK	First Interstate BancSystem Inc.
FINL	The Finish Line Inc.
FIRE	Sourcefire Inc.
FISI	Financial Institutions Inc.
FISV	Fiserv Inc.
FITB	Fifth Third Bancorp
FITBP	Fifth Third Bancorp
FIZZ	National Beverage Corp.
FLDM	Fluidigm Corporation
FLEX	Flextronics International Ltd.
FLIC	The First of Long Island Corporation
FLIR	FLIR Systems Inc.
FLML	Flamel Technologies S.A.
FLOW	Flow International Corporation
FLWS	1-800 FLOWERS.COM Inc.
FLXS	Flexsteel Industries Inc.
FMAR	First Mariner Bancorp
FMBI	First Midwest Bancorp Inc.
FMCN	Focus Media Holding Limited
FMER	FirstMerit Corporation
FMFC	First M & F Corporation
FNBN	FNB United Corp.
FNDT	Fundtech Ltd.
FNFG	First Niagara Financial Group Inc.
FNGN	Financial Engines Inc.
FNLC	First Bancorp Inc (ME)
FNSR	Finisar Corporation
FOLD	Amicus Therapeutics Inc.
FONR	Fonar Corporation
FORD	Forward Industries Inc.
FORM	FormFactor Inc.
FORR	Forrester Research Inc.
FORTY	Formula Systems (1985) Ltd.
FOSL	Fossil Inc.
FPBI	FPB Bancorp Inc.
FPFC	First Place Financial Corp.
FPIC	FPIC Insurance Group Inc.
FPTB	First PacTrust Bancorp Inc.
FRBK	Republic First Bancorp Inc.
FRCCO	First Republic Preferred Capital Corporation
FRED	Fred's Inc.
FREE	FreeSeas Inc.
FREEZ	FreeSeas Inc.
FRME	First Merchants Corporation
FRP	FairPoint Communications Inc.
FRPT	Force Protection Inc.
FSBI	Fidelity Bancorp Inc.
FSBK	First South Bancorp Inc
FSCI	Fisher Communications Inc.
FSFG	First Savings Financial Group Inc.
FSGI	First Security Group Inc.
FSII	FSI International Inc.
FSIN	Fushi Copperweld Inc.
FSLR	First Solar Inc.
FSRV	FirstService Corporation
FSTR	L.B. Foster Company
FSYS	Fuel Systems Solutions Inc.
FTEK	Fuel Tech Inc.
FTLK	Funtalk China Holdings Limited
FTNT	Fortinet Inc.
FTWR	FiberTower Corporation
FUBC	1st United Bancorp Inc. (FL)
FUEL	SMF Energy Corporation
FULL	Full Circle Capital Corporation
FULT	Fulton Financial Corporation
FUNC	First United Corporation
FUND	Royce Focus Trust Inc.
FUQI	Fuqi International Inc.
FURX	Furiex Pharmaceuticals Inc.
FWLT	Foster Wheeler AG.
FWRD	Forward Air Corporation
FXCB	Fox Chase Bancorp Inc.
FXEN	FX Energy Inc.
GABC	German American Bancorp Inc.
GAGA	Le Gaga Holdings Limited
GAI	Global-Tech Advanced Innovations Inc.
GAIA	Gaiam Inc.
GAIN	Gladstone Investment Corporation
GAME	Shanda Games Limited
GASS	StealthGas Inc.
GBCI	Glacier Bancorp Inc.
GBDC	Golub Capital BDC Inc.
GBLI	Global Indemnity plc
GBNK	Guaranty Bancorp
GCBC	Greene County Bancorp Inc.
GCFB	Granite City Food And Brewery Ltd.
GCOM	Globecomm Systems Inc.
GEDU	Global Education & Technology Group Ltd
GENC	Gencor Industries Inc.
GENE	Genetic Technologies Ltd
GENT	Gentium SpA
GENZ	Genzyme Corporation
GEOI	GeoResources Inc.
GEOY	GeoEye Inc.
GERN	Geron Corporation
GEVO	Gevo Inc.
GFED	Guaranty Federal Bancshares Inc.
GFN	General Finance Corporation
GFNCL	General Finance Corporation
GFRE	Gulf Resources Inc.
GGAL	Grupo Financiero Galicia S.A.
GHDX	Genomic Health Inc.
GIFI	Gulf Island Fabrication Inc.
GIGA	Giga-tronics Incorporated
GIGM	GigaMedia Limited
GIII	G-III Apparel Group LTD.
GILD	Gilead Sciences Inc.
GILT	Gilat Satellite Networks Ltd.
GIVN	Given Imaging Ltd.
GKNT	Geeknet Inc.
GKSR	G&K Services Inc.
GLAD	Gladstone Capital Corporation
GLBC	Global Crossing Ltd.
GLBL	Global Industries Ltd.
GLBS	Globus Maritime Limited
GLBZ	Glen Burnie Bancorp
GLCH	Gleacher & Company Inc.
GLDC	Golden Enterprises Inc.
GLDD	Great Lakes Dredge & Dock Corporation
GLGL	GLG Life Tech Corp
GLNG	Golar LNG Limited
GLOI	GlobalOptions Group Inc.
GLPW	Global Power Equipment Group Inc
GLRE	Greenlight Capital Re Ltd.
GLUU	Glu Mobile Inc.
GMAN	Gordmans Stores Inc.
GMCR	Green Mountain Coffee Roasters Inc.
GMET	GeoMet Inc.
GMETP	GeoMet Inc.
GMTC	GameTech International Inc.
GNCMA	General Communication Inc.
GNET	Global Traffic Network Inc.
GNMK	GenMark Diagnostics Inc.
GNOM	Complete Genomics Inc.
GNTX	Gentex Corporation
GNVC	GenVec Inc.
GOLD	Randgold Resources Limited
GOLF	Golfsmith International Holdings Inc.
GOOD	Gladstone Commercial Corporation
GOODO	Gladstone Commercial Corporation
GOODP	Gladstone Commercial Corporation
GOOG	Google Inc.
GPIC	Gaming Partners International Corporation
GPOR	Gulfport Energy Corporation
GPRC	Guanwei Recycling Corp.
GPRE	Green Plains Renewable Energy Inc.
GPRO	Gen-Probe Incorporated
GRAN	Bank of Granite Corporation
GRID	First Trust NASDAQ Clean Edge Smart Grid Infrastructure Index Fund
GRIF	Griffin Land & Nurseries Inc.
GRMH	GrayMark Healthcare Inc.
GRMN	Garmin Ltd.
GRNB	Green Bankshares Inc.
GROW	U.S. Global Investors Inc.
GRRF	China Grentech Corporation Limited
GRVY	GRAVITY Co. Ltd.
GSAT	Globalstar Inc.
GSBC	Great Southern Bancorp Inc.
GSIC	GSI Commerce Inc.
GSIG	GSI Group Inc.
GSIT	GSI Technology Inc.
GSLA	GS Financial Corp.
GSM	Globe Specialty Metals Inc.
GSOL	Global Sources Ltd.
GTEC	Global Defense Technology and Systems Inc.
GTIM	Good Times Restaurants Inc.
GTIV	Gentiva Health Services Inc.
GTLS	Chart Industries Inc.
GTSI	GTSI Corp.
GTXI	GTx Inc.
GUID	Guidance Software Inc.
GULF	WisdomTree Middle East Dividend Fund
GXDX	Genoptix Inc.
GYRO	Gyrodyne Company of America Inc.
HA	Hawaiian Holdings Inc.
HAFC	Hanmi Financial Corporation
HAIN	The Hain Celestial Group Inc.
HALL	Hallmark Financial Services Inc.
HALO	Halozyme Therapeutics Inc.
HANS	Hansen Natural Corporation
HARL	Harleysville Savings Bank
HAS	Hasbro Inc.
HAST	Hastings Entertainment Inc.
HAUP	Hauppauge Digital Inc.
HAVNP	New York Community Bancorp Inc.
HAWK	Seahawk Drilling Inc.
HAYN	Haynes International Inc.
HBAN	Huntington Bancshares Incorporated
HBANP	Huntington Bancshares Incorporated
HBCP	Home Bancorp Inc.
HBHC	Hancock Holding Company
HBIO	Harvard Bioscience Inc.
HBNC	Horizon Bancorp (IN)
HBNK	Hampden Bancorp Inc.
HBOS	Heritage Financial Group
HCBK	Hudson City Bancorp Inc.
HCCI	Heritage-Crystal Clean Inc.
HCII	Homeowners Choice Inc.
HCIIW	Homeowners Choice Inc.
HCKT	The Hackett Group Inc.
HCSG	Healthcare Services Group Inc.
HDNG	Hardinge Inc.
HDSN	Hudson Technologies Inc.
HEAT	SmartHeat Inc.
HEES	H&E Equipment Services Inc.
HELE	Helen of Troy Limited
HEOP	Heritage Oaks Bancorp
HERO	Hercules Offshore Inc.
HEV	Ener1 Inc
HFBC	HopFed Bancorp Inc.
HFBL	Home Federal Bancorp Inc. of Louisiana
HFFC	HF Financial Corp.
HFWA	Heritage Financial Corporation
HGIC	Harleysville Group Inc.
HGSH	China HGS Real Estate Inc.
HGSI	Human Genome Sciences Inc.
HHGP	Hudson Highland Group Inc.
HIBB	Hibbett Sports Inc.
HIFS	Hingham Institution for Savings
HIHO	Highway Holdings Limited
HILL	Dot Hill Systems Corporation
HIMX	Himax Technologies Inc.
HITK	Hi-Tech Pharmacal Co. Inc.
HITT	Hittite Microwave Corporation
HLIT	Harmonic Inc.
HLYS	Heelys Inc.
HMIN	Home Inns & Hotels Management Inc.
HMNA	Helios & Matheson North America Inc.
HMNF	HMN Financial Inc.
HMPR	Hampton Roads Bankshares Inc
HMSY	HMS Holdings Corp
HNH	Handy & Harman Ltd.
HNRG	Hallador Energy Company
HNSN	Hansen Medical Inc.
HOFT	Hooker Furniture Corporation
HOGS	Zhongpin Inc.
HOKU	Hoku Corporation
HOLI	Hollysys Automation Technologies Ltd.
HOLL	Hollywood Media Corp.
HOLX	Hologic Inc.
HOMB	Home BancShares Inc.
HOME	Home Federal Bancorp Inc.
HOOK	Craft Brewers Alliance Inc
HOTT	Hot Topic Inc.
HOVNP	Hovnanian Enterprises Inc
HPCCP	Huntington Preferred Capital Inc.
HPJ	Hong Kong Highpower Technology
HPOL	Harris Interactive Inc.
HRBN	Harbin Electric Inc.
HRLY	Herley Industries Inc.
HRZN	Horizon Technology Finance Corporation
HSFT	HiSoft Technology International Limited
HSIC	Henry Schein Inc.
HSII	Heidrick & Struggles International Inc.
HSKA	Heska Corporation
HSNI	HSN Inc.
HSOL	Hanwha SolarOne Co. Ltd.
HSTM	HealthStream Inc.
HSWI	HSW International Inc.
HTBK	Heritage Commerce Corp
HTCH	Hutchinson Technology Incorporated
HTCO	Hickory Tech Corporation
HTGC	Hercules Technology Growth Capital Inc.
HTHT	China Lodging Group Limited
HTLD	Heartland Express Inc.
HTLF	Heartland Financial USA Inc.
HTWR	Heartware International Inc.
HUBG	Hub Group Inc.
HUGH	Hughes Communications Inc
HURC	Hurco Companies Inc.
HURN	Huron Consulting Group Inc.
HUVL	Hudson Valley Holding Corp.
HWAY	Healthways Inc.
HWBK	Hawthorn Bancshares Inc.
HWCC	Houston Wire & Cable Company
HWKN	Hawkins Inc.
HYGS	Hydrogenics Corporation
IACI	IAC/InterActiveCorp
IART	Integra LifeSciences Holdings Corporation
IBB	iShares NASDAQ Biotechnology Index Fund
IBCA	Intervest Bancshares Corp.
IBCP	Independent Bank Corporation
IBCPO	Independent Bank Corporation
IBKC	IBERIABANK Corporation
IBKR	Interactive Brokers Group Inc.
IBNK	Integra Bank Corporation
IBOC	International Bancshares Corporation
ICAD	icad inc.
ICCC	ImmuCell Corporation
ICFI	ICF International Inc.
ICGE	Internet Capital Group Inc.
ICGN	Icagen Inc.
ICLK	interCLICK Inc.
ICLN	iShares S&P Global Clean Energy Index Fund
ICLR	ICON plc
ICOG	ICO Global Communications Holdings Limited DE
ICON	Iconix Brand Group Inc.
ICUI	ICU Medical Inc.
IDCC	InterDigital Inc.
IDIX	Idenix Pharmaceuticals Inc.
IDRA	Idera Pharmaceuticals Inc.
IDSA	Industrial Services of America Inc.
IDSY	I.D. Systems Inc.
IDTI	Integrated Device Technology Inc.
IDXX	IDEXX Laboratories Inc.
IESC	Integrated Electrical Services Inc.
IFAS	iShares FTSE EPRA/NAREIT Asia Index Fund
IFEU	iShares FTSE EPRA/NAREIT Europe Index Fund
IFGL	iShares FTSE EPRA/NAREIT Global Real Estate ex-U.S. Index Fund
IFNA	iShares FTSE EPRA/NAREIT North America Index Fund
IFON	InfoSonics Corp
IFSIA	Interface Inc.
IFSM	iShares FTSE Developed Small Cap ex-North America Index Fund
IGLD	Internet Gold Golden Lines Ltd.
IGOI	iGo Inc
IGOV	iShares S&P/Citigroup International Treasury Bond Fund
IGTE	iGATE Corporation
III	Information Services Group Inc.
IIIN	Insteel Industries Inc.
IIJI	Internet Initiative Japan Inc.
IILG	Interval Leisure Group Inc.
IIN	IntriCon Corporation
IIVI	II-VI Incorporated
IKAN	Ikanos Communications Inc.
IKNX	Ikonics Corporation
ILMN	Illumina Inc.
IMGN	ImmunoGen Inc.
IMKTA	Ingles Markets Incorporated
IMMR	Immersion Corporation
IMMU	Immunomedics Inc.
IMOS	ChipMOS TECHNOLOGIES (Bermuda) LTD.
IMOSD	ChipMOS TECHNOLOGIES (Bermuda) LTD.
IMRS	Imris Inc
INAP	Internap Network Services Corporation
INCB	Indiana Community Bancorp
INCY	Incyte Corporation
INDB	Independent Bank Corp.
INDY	iShares S&P India Nifty 50 Index Fund
INFA	Informatica Corporation
INFI	Infinity Pharmaceuticals Inc.
INFN	Infinera Corporation
INFY	Infosys Technologies Limited
INHX	Inhibitex Inc.
ININ	Interactive Intelligence Inc.
INMD	IntegraMed America Inc.
INOC	Innotrac Corporation
INOD	Innodata Isogen Inc
INPH	Interphase Corporation
INSM	Insmed Inc.
INSMD	Insmed
INSP	InfoSpace Inc.
INSU	Insituform Technologies Inc.
INSW	InsWeb Corporation
INTC	Intel Corporation
INTG	The Intergroup Corporation
INTL	INTL FCStone Inc.
INTT	inTest Corporation
INTU	Intuit Inc.
INTX	Intersections Inc.
INVE	Identive Group Inc.
INWK	InnerWorkings Inc.
INXI	INX Inc.
IOSP	Innospec Inc.
IPAR	Inter Parfums Inc.
IPAS	iPass Inc.
IPCC	Infinity Property and Casualty Corporation
IPCI	Intellipharmaceutics International Inc.
IPCM	IPC The Hospitalist Company Inc.
IPGP	IPG Photonics Corporation
IPHS	Innophos Holdings Inc.
IPSU	Imperial Sugar Company
IPXL	Impax Laboratories Inc.
IRBT	iRobot Corporation
IRDM	Iridium Communications Inc
IRDMU	Iridium Communications Inc
IRDMW	Iridium Communications Inc
IRDMZ	Iridium Communications Inc
IRET	Investors Real Estate Trust
IRETP	Investors Real Estate Trust
IRIS	IRIS International Inc.
IRIX	IRIDEX Corporation
IRWD	Ironwood Pharmaceuticals Inc.
ISBC	Investors Bancorp Inc.
ISCA	International Speedway Corporation
ISHG	iShares S&P/Citigroup 1-3 Year International Treasury Bond Fund
ISIG	Insignia Systems Inc.
ISIL	Intersil Corporation
ISIS	Isis Pharmaceuticals Inc.
ISLE	Isle of Capri Casinos Inc.
ISNS	Image Sensing Systems Inc.
ISPH	Inspire Pharmaceuticals Inc.
ISRG	Intuitive Surgical Inc.
ISRL	Isramco Inc.
ISSC	Innovative Solutions and Support Inc.
ISSI	Integrated Silicon Solution Inc.
ISTA	ISTA Pharmaceuticals Inc.
ISYS	Integral Systems Inc.
ITIC	Investors Title Company
ITMN	InterMune Inc.
ITRI	Itron Inc.
ITRN	Ituran Location and Control Ltd.
IVAC	Intevac Inc.
IVAN	Ivanhoe Energy Inc.
IXYS	IXYS Corporation
JACK	Jack In The Box Inc.
JADE	LJ International Inc.
JAKK	JAKKS Pacific Inc.
JASO	JA Solar Holdings Co. Ltd.
JAX	J. Alexander's Corporation
JAXB	Jacksonville Bancorp Inc.
JAZZ	Jazz Pharmaceuticals Inc.
JBHT	J.B. Hunt Transport Services Inc.
JBLU	JetBlue Airways Corporation
JBSS	John B. Sanfilippo & Son Inc.
JCDA	Jacada Ltd.
JCOM	j2 Global Communications Inc
JCS	Communications Systems Inc.
JCTCF	Jewett-Cameron Trading Company
JDAS	JDA Software Group Inc.
JDSU	JDS Uniphase Corporation
JFBC	Jeffersonville Bancorp
JFBI	Jefferson Bancshares Inc.
JGBO	Jiangbo Pharmaceuticals Inc.
JJSF	J & J Snack Foods Corp.
JKHY	Jack Henry & Associates Inc.
JMBA	Jamba Inc.
JNGW	Jingwei International Limited
JOBS	51job Inc.
JOEZ	Joe's Jeans Inc.
JOSB	Jos. A. Bank Clothiers Inc.
JOUT	Johnson Outdoors Inc.
JOYG	Joy Global Inc.
JRCC	James River Coal Company
JRJC	China Finance Online Co. Limited
JSDA	Jones Soda Co.
JST	Jinpan International Limited
JVA	Coffee Holding Co. Inc.
JXSB	Jacksonville Bancorp Inc.
KALU	Kaiser Aluminum Corporation
KAMN	Kaman Corporation
KBALB	Kimball International Inc.
KCAP	Kohlberg Capital Corporation
KCLI	Kansas City Life Insurance Company
KELYA	Kelly Services Inc.
KELYB	Kelly Services Inc.
KENT	Kent Financial Services Inc.
KEQU	Kewaunee Scientific Corporation
KERX	Keryx Biopharmaceuticals Inc.
KEYN	Keynote Systems Inc.
KEYP	Keyuan Petrochemicals Inc.
KEYW	The KEYW Holding Corporation
KFFB	Kentucky First Federal Bancorp
KFFG	Kaiser Federal Financial Group Inc.
KFRC	Kforce Inc.
KGJI	Kingold Jewelry Inc.
KINS	Kingstone Companies Inc
KIPS	Kips Bay Medical Inc.
KIRK	Kirkland's Inc.
KITD	KIT digital Inc.
KLAC	KLA-Tencor Corporation
KLIC	Kulicke and Soffa Industries Inc.
KMGB	KMG Chemicals Inc.
KNDI	Kandi Technolgies Corp.
KNDL	Kendle International Inc.
KNOL	Knology Inc.
KNOT	The Knot Inc.
KNSY	Kensey Nash Corporation
KNXA	Kenexa Corporation
KONA	Kona Grill Inc.
KONE	Kingtone Wirelessinfo Solution Holding Ltd
KONG	KongZhong Corporation
KOOL	THERMOGENESIS Corp.
KOPN	Kopin Corporation
KOSS	Koss Corporation
KRNY	Kearny Financial
KSW	KSW Inc
KSWS	K-Swiss Inc.
KTCC	Key Tronic Corporation
KTEC	Key Technology Inc.
KTOS	Kratos Defense & Security Solutions Inc.
KUTV	Ku6 Media Co. Ltd.
KVHI	KVH Industries Inc.
LABC	Louisiana Bancorp Inc.
LABL	Multi-Color Corporation
LACO	Lakes Entertainment Inc.
LAKE	Lakeland Industries Inc.
LAMR	Lamar Advertising Company
LANC	Lancaster Colony Corporation
LARK	Landmark Bancorp Inc.
LAVA	Magma Design Automation Inc.
LAWS	Lawson Products Inc.
LAYN	Layne Christensen Company
LBAI	Lakeland Bancorp Inc.
LBIX	Leading Brands Inc
LBTYA	Liberty Global Inc.
LBTYB	Liberty Global Inc.
LBTYK	Liberty Global Inc.
LCAPA	Liberty Media Corporation
LCAPB	Liberty Media Corporation
LCAV	LCA-Vision Inc.
LCRY	LeCroy Corporation
LCUT	Lifetime Brands Inc.
LDSH	Ladish Co. Inc.
LEAP	Leap Wireless International Inc.
LECO	Lincoln Electric Holdings Inc.
LEDR	Market Leader Inc
LEDS	SemiLEDS Corporation
LEGC	Legacy Bancorp Inc.
LFUS	Littelfuse Inc.
LGCY	Legacy Reserves LP
LGND	Ligand Pharmaceuticals Incorporated
LHCG	LHC Group
LIFE	Life Technologies Corporation
LIME	lime energy co.
LINC	Lincoln Educational Services Corporation
LINE	Linn Energy LLC
LINTA	Liberty Media Corporation
LINTB	Liberty Media Corporation
LION	Fidelity Southern Corporation
LIOX	Lionbridge Technologies Inc.
LIVE	LiveDeal Inc.
LIWA	Lihua International Inc.
LKFN	Lakeland Financial Corporation
LKQX	LKQ Corporation
LLEN	L&L Energy Inc.
LLNW	Limelight Networks Inc.
LLTC	Linear Technology Corporation
LMAT	LeMaitre Vascular Inc.
LMIA	LMI Aerospace Inc.
LMLP	LML Payment Systems Inc.
LMNR	Limoneira Co
LMNX	Luminex Corporation
LNBB	LNB Bancorp Inc.
LNCE	Lance Inc.
LNCR	Lincare Holdings Inc.
LNDC	Landec Corporation
LNET	LodgeNet Interactive Corporation
LOAN	Manhattan Bridge Capital Inc
LOCM	Local.com Corporation
LOGC	Logic Devices Incorporated
LOGI	Logitech International S.A.
LOGM	LogMein Inc.
LOJN	LoJack Corporation
LONG	eLong Inc.
LOOK	LookSmart Ltd.
LOOP	LoopNet Inc.
LOPE	Grand Canyon Education Inc.
LORL	Loral Space and Communications Inc.
LPHI	Life Partners Holdings Inc
LPLA	LPL Investment Holdings Inc.
LPNT	LifePoint Hospitals Inc.
LPSB	LaPorte Bancorp Inc.
LPSN	LivePerson Inc.
LPTH	LightPath Technologies Inc.
LQDT	Liquidity Services Inc.
LRAD	LRAD Corporation
LRCX	Lam Research Corporation
LSBI	LSB Financial Corp.
LSBK	Lake Shore Bancorp Inc.
LSCC	Lattice Semiconductor Corporation
LSTR	Landstar System Inc.
LSTZA	Liberty Media Corporation
LSTZB	Liberty Media Corporation
LTBR	Lightbridge Corporation
LTON	Linktone Ltd.
LTRE	Learning Tree International Inc.
LTRX	Lantronix Inc.
LTXC	LTX-Credence Corporation
LUFK	Lufkin Industries Inc.
LULU	lululemon athletica inc.
LUNA	Luna Innovations Incorporated
LVLT	Level 3 Communications Inc.
LWAY	Lifeway Foods Inc.
LWSN	Lawson Software Inc.
LXRX	Lexicon Pharmaceuticals Inc.
LYTS	LSI Industries Inc.
LZEN	Lizhan Environmental Corporation
MAGS	Magal Security Systems Ltd.
MAIL	IncrediMail Ltd.
MAJC	Majestic Capital Ltd.
MAKO	MAKO Surgical Corp.
MALL	PC Mall Inc.
MANH	Manhattan Associates Inc.
MANT	ManTech International Corporation
MAPP	MAP Pharmaceuticals Inc.
MARPS	Marine Petroleum Trust
MASC	Material Sciences Corporation
MASI	Masimo Corporation
MAT	Mattel Inc.
MATK	Martek Biosciences Corporation
MATW	Matthews International Corporation
MAXY	Maxygen Inc.
MAYS	J. W. Mays Inc.
MBFI	MB Financial Inc.
MBLX	Metabolix Inc.
MBND	Multiband Corporation
MBRG	Middleburg Financial Corporation
MBTF	M B T Financial Corp
MBVT	Merchants Bancshares Inc.
MBWM	Mercantile Bank Corporation
MCBC	Macatawa Bank Corporation
MCBF	Monarch Community Bancorp Inc.
MCBI	MetroCorp Bancshares Inc.
MCCC	Mediacom Communications Corporation
MCGC	MCG Capital Corporation
MCHP	Microchip Technology Incorporated
MCHX	Marchex Inc.
MCOX	Mecox Lane Limited
MCRI	Monarch Casino & Resort Inc.
MCRL	Micrel Incorporated
MCRS	MICROS Systems Inc.
MDAS	MedAssets Inc.
MDCA	MDC Partners Inc.
MDCI	Medical Action Industries Inc.
MDCO	The Medicines Company
MDH	MHI Hospitality Corporation
MDMD	MediaMind Technologies Inc.
MDRX	Allscripts Healthcare Solutions Inc.
MDSO	Medidata Solutions Inc.
MDTH	MedCath Corporation
MDVN	Medivation Inc.
MEAD	Meade Instruments Corp.
MEAS	Measurement Specialties Inc.
MEDH	MedQuist Holdings Inc.
MEDQ	MedQuist Inc.
MEDW	MEDIWARE Information Systems Inc.
MELA	MELA Sciences Inc
MELI	MercadoLibre Inc.
MEMS	MEMSIC Inc.
MENT	Mentor Graphics Corporation
MEOH	Methanex Corporation
MERC	Mercer International Inc.
MERR	Merriman Holdings Inc.
MERU	Meru Networks Inc.
METR	Metro Bancorp Inc
MFI	MicroFinancial Incorporated
MFLR	Mayflower Bancorp Inc.
MFLX	Multi-Fineline Electronix Inc.
MFNC	Mackinac Financial Corporation
MFRI	MFRI Inc.
MFSF	MutualFirst Financial Inc.
MGAM	Multimedia Games Inc.
MGEE	MGE Energy Inc.
MGIC	Magic Software Enterprises Ltd.
MGLN	Magellan Health Services Inc.
MGPI	MGP Ingredients Inc.
MGRC	McGrath RentCorp
MGYR	Magyar Bancorp Inc.
MHGC	Morgans Hotel Group Co.
MHLD	Maiden Hldgs Ltd
MICC	Millicom International Cellular S.A.
MIDD	The Middleby Corporation
MIGP	Mercer Insurance Group Inc.
MILL	Miller Petroleum Inc.
MIND	Mitcham Industries Inc.
MINI	Mobile Mini Inc.
MIPS	MIPS Technologies Inc.
MITI	Micromet Inc.
MITL	Mitel Networks Corporation
MITSY	Mitsui & Company Ltd.
MKSI	MKS Instruments Inc.
MKTAY	Makita Corp.
MKTX	MarketAxess Holdings Inc.
MLAB	Mesa Laboratories Inc.
MLHR	Herman Miller Inc.
MLNK	ModusLink Global Solutions Inc
MLNX	Mellanox Technologies Ltd.
MLVF	Malvern Federal Bancorp Inc.
MMLP	Martin Midstream Partners L.P.
MMSI	Merit Medical Systems Inc.
MMUS	MakeMusic Inc.
MMYT	MakeMyTrip Limited
MNDO	MIND C.T.I. Ltd.
MNKD	MannKind Corporation
MNNY	Merrill Lynch & Co. Inc.
MNOV	MediciNova Inc.
MNRK	Monarch Financial Holdings Inc.
MNRKP	Monarch Financial Holdings Inc.
MNRO	Monro Muffler Brake Inc.
MNTA	Momenta Pharmaceuticals Inc.
MNTG	MTR Gaming Group Inc.
MNTX	Manitex International Inc.
MOBI	Sky-mobi Limited
MOCO	MOCON Inc.
MOFG	MidWestOne Financial Group Inc.
MOLX	Molex Incorporated
MOLXA	Molex Incorporated
MORN	Morningstar Inc.
MOSY	MoSys Inc.
MOTR	Motricity Inc.
MOVE	Move Inc.
MPAA	Motorcar Parts of America Inc.
MPAC	MOD-PAC CORP.
MPB	Mid Penn Bancorp
MPEL	Melco Crown Entertainment Limited
MPET	Magellan Petroleum Corporation
MPWR	Monolithic Power Systems Inc.
MRCY	Mercury Computer Systems
MRGE	Merge Healthcare Incorporated.
MRLN	Marlin Business Services Corp.
MRNA	Marina Biotech Inc.
MRTN	Marten Transport Ltd.
MRVL	Marvell Technology Group Ltd.
MSBF	MSB Financial Corp.
MSCC	Microsemi Corporation
MSDXP	BB&T Corporation
MSEX	Middlesex Water Company
MSFG	MainSource Financial Group Inc.
MSFT	Microsoft Corporation
MSG	Madison Square Garden Inc.
MSHL	Marshall Edwards Inc.
MSON	MISONIX Inc.
MSPD	Mindspeed Technologies Inc.
MSSR	McCormick & Schmick's Seafood Restaurants Inc.
MSTR	MicroStrategy Incorporated
MSW	Mission West Properties Inc.
MTEX	Mannatech Incorporated
MTLK	Metalink Ltd.
MTOX	Medtox Scientific Inc.
MTRX	Matrix Service Company
MTSC	MTS Systems Corporation
MTSL	MER Telemanagement Solutions Ltd.
MTSN	Mattson Technology Inc.
MTTX	Merrill Lynch & Co. Inc.
MTXX	Matrixx Initiatives Inc.
MU	Micron Technology Inc.
MVIS	Microvision Inc.
MVISW	Microvision Inc.
MWIV	MWI Veterinary Supply Inc.
MXIM	Maxim Integrated Products Inc.
MXWL	Maxwell Technologies Inc.
MYGN	Myriad Genetics Inc.
MYL	Mylan Inc.
MYRG	MYR Group Inc.
MYRX	Myrexis Inc
NABI	Nabi Biopharmaceuticals
NAFC	Nash-Finch Company
NAII	Natural Alternatives International Inc.
NANO	Nanometrics Incorporated
NANX	Nanophase Technologies Corporation
NARA	Nara Bancorp Inc.
NASB	NASB Financial Inc.
NATH	Nathan's Famous Inc.
NATI	National Instruments Corporation
NATL	National Interstate Corporation
NATR	Nature's Sunshine Products Inc.
NAUH	National American University Holdings Inc.
NAVG	The Navigators Group Inc.
NAVI	NaviSite Inc.
NAVR	Navarre Corporation
NBBC	NewBridge Bancorp
NBIX	Neurocrine Biosciences Inc.
NBN	Northeast Bancorp
NBTB	NBT Bancorp Inc.
NBTF	NB&T FINANCIAL GROUP INC
NBXH	Morgan Stanley
NCBC	New Century Bancorp Inc. (NC)
NCIT	NCI Inc.
NCMI	National CineMedia Inc.
NCTY	The9 Limited
NDAQ	The NASDAQ OMX Group Inc.
NDSN	Nordson Corporation
NEBS	New England Bancshares Inc.
NECB	Northeast Community Bancorp Inc.
NEI	Network Engines Inc
NEOG	Neogen Corporation
NEPT	Neptune Technologies & Bioresources Inc
NETC	NET Servicos de Comunicacao S.A.
NETL	NetLogic Microsystems Inc.
NEWL	NewLead Holdings Ltd.
NEWP	Newport Corporation
NEWS	NewStar Financial Inc.
NEWT	Newtek Business Services Inc.
NEXS	Nexxus Lighting Inc.
NFBK	Northfield Bancorp Inc.
NFEC	NF Energy Saving Corporation
NFLX	Netflix Inc.
NFSB	Newport Bancorp Inc.
NGAS	NGAS Resources Inc.
NGPC	NGP Capital Resources Company
NGSX	NeurogesX Inc.
NHTB	New Hampshire Thrift Bancshares Inc.
NICE	NICE-Systems Limited
NICK	Nicholas Financial Inc.
NIHD	NII Holdings Inc.
NILE	Blue Nile Inc.
NINE	Ninetowns Internet Technology Group Company Limited
NKBP	China Nuokang Bio-Pharmaceutical Inc.
NKSH	National Bankshares Inc.
NKTR	Nektar Therapeutics
NLCI	Nobel Learning Communities Inc.
NLST	Netlist Inc.
NLTX	Nile Therapeutics Inc.
NLTXW	Nile Therapeutics Inc.
NMRX	Numerex Corp.
NMTI	NMT Medical Inc.
NNBR	NN Inc.
NOBH	Nobility Homes Inc.
NOEC	New Oriental Energy & Chemical Corp.
NOIZ	Micronetics Inc.
NOOF	New Frontier Media Inc.
NOVA	NovaMed Inc.
NOVB	North Valley Bancorp
NOVL	Novell Inc.
NPBC	National Penn Bancshares Inc.
NPBCO	National Penn Bancshares Inc.
NPSP	NPS Pharmaceuticals Inc.
NRCI	National Research Corporation
NRIM	Northrim BanCorp Inc
NSEC	National Security Group Inc.
NSFC	Northern States Financial Corporation
NSIT	Insight Enterprises Inc.
NSPH	Nanosphere Inc.
NSSC	NAPCO Security Technologies Inc.
NSTC	Ness Technologies Inc.
NSYS	Nortech Systems Incorporated
NTAP	NetApp Inc.
NTCT	NetScout Systems Inc.
NTES	Netease.com Inc.
NTGR	NETGEAR Inc.
NTIC	Northern Technologies International Corporation
NTLS	NTELOS Holdings Corp.
NTRI	NutriSystem Inc
NTRS	Northern Trust Corporation
NTSC	National Technical Systems Inc.
NTSP	NetSpend Holdings Inc.
NTWK	NetSol Technologies Inc.
NUAN	Nuance Communications Inc.
NUCL	iShares S&P Global Nuclear Index Fund
NURO	NeuroMetrix Inc.
NUTR	Nutraceutical International Corporation
NUVA	NuVasive Inc.
NVAX	Novavax Inc.
NVDA	NVIDIA Corporation
NVEC	NVE Corporation
NVGN	Novogen Limited
NVLS	Novellus Systems Inc.
NVMI	Nova Measuring Instruments Ltd.
NVSL	Naugatuck Valley Financial Corporation
NVTL	Novatel Wireless Inc.
NWBI	Northwest Bancshares Inc.
NWFL	Norwood Financial Corp.
NWK	Network Equipment Technologies Inc.
NWLI	National Western Life Insurance Company
NWPX	Northwest Pipe Company
NWS	News Corporation
NWSA	News Corporation
NXPI	NXP Semiconductors N.V.
NXST	Nexstar Broadcasting Group Inc.
NXTM	NxStage Medical Inc.
NYMT	New York Mortgage Trust Inc.
NYMX	Nymox Pharmaceutical Corporation
NYNY	Empire Resorts Inc.
OABC	OmniAmerican Bancorp Inc.
OBAF	OBA Financial Services Inc.
OBAS	Optibase Ltd.
OBCI	Ocean Bio-Chem Inc.
OCCF	Optical Cable Corporation
OCFC	OceanFirst Financial Corp.
OCLR	Oclaro Inc.
OCLS	Oculus Innovative Sciences Inc.
OCNF	OceanFreight Inc.
OCNW	Occam Networks Inc.
OCZ	OCZ Technology Group Inc
ODFL	Old Dominion Freight Line Inc.
OFED	Oconee Federal Financial Corp.
OFIX	Orthofix International N.V.
OFLX	Omega Flex Inc.
OGXI	OncoGenex Pharmaceuticals Inc.
OIIM	O2Micro International Limited
OINK	Tianli Agritech Inc.
OKSB	Southwest Bancorp Inc.
OKSBP	Southwest Bancorp Inc.
OLBK	Old Line Bancshares Inc.
OLCB	Ohio Legacy Corporation
OMAB	Grupo Aeroportuario del Centro Norte S.A.B. de C.V.
OMCL	Omnicell Inc.
OMER	Omeros Corporation
OMEX	Odyssey Marine Exploration Inc.
OMPI	Obagi Medical Products Inc.
ONAV	Omega Navigation Enterprises Inc.
ONCY	Oncolytics Biotech Inc.
ONEQ	Fidelity Nasdaq Composite Index Tracking Stock
ONFC	Oneida Financial Corp.
ONNN	ON Semiconductor Corporation
ONSM	Onstream Media Corporation
ONTY	Oncothyreon Inc .
ONVI	Onvia Inc.
ONXX	ONYX Pharmaceuticals Inc.
OPEN	OpenTable Inc.
OPHC	OptimumBank Holdings Inc.
OPLK	Oplink Communications Inc.
OPNT	OPNET Technologies Inc.
OPOF	Old Point Financial Corporation
OPTR	Optimer Pharmaceuticals Inc.
OPTT	Ocean Power Technologies Inc.
OPWV	Openwave Systems Inc
OPXA	Opexa Therapeutics Inc.
OPXAW	Opexa Therapeutics Inc.
OPXT	Opnext Inc.
ORBC	ORBCOMM Inc.
ORBK	Orbotech Ltd.
ORBT	Orbit International Corporation
ORCC	Online Resources Corporation
ORCH	Orchid Cellmark Inc.
ORCL	Oracle Corporation
ORCT	Orckit Communications Limited
OREX	Orexigen Therapeutics Inc.
ORIT	Oritani Financial Corp.
ORLY	O'Reilly Automotive Inc.
ORRF	Orrstown Financial Services Inc
OSBC	Old Second Bancorp Inc.
OSBCP	Old Second Bancorp Inc.
OSHC	Ocean Shore Holding Co.
OSIR	Osiris Therapeutics Inc.
OSIS	OSI Systems Inc.
OSN	Ossen Innovation Co. Ltd.
OSTK	Overstock.com Inc.
OSUR	OraSure Technologies Inc.
OTEX	Open Text Corporation
OTIV	On Track Innovations Ltd
OTT	Otelco Inc.
OTTR	Otter Tail Corporation
OUTD	Outdoor Channel Holdings Inc.
OVBC	Ohio Valley Banc Corp.
OVLY	Oak Valley Bancorp (CA)
OVRL	Overland Storage Inc.
OVTI	OmniVision Technologies Inc.
OXBT	Oxygen Biotherapeutics Inc.
OXGN	OXiGENE Inc.
OXGND	OXiGENE Inc.
OXLC	Oxford Lane Capital Corp.
OXPS	optionsXpress Holdings Inc.
OYOG	OYO Geospace Corporation
OZRK	Bank of the Ozarks
PAAS	Pan American Silver Corp.
PABK	PAB Bankshares Inc.
PACB	Pacific Biosciences of California Inc.
PACR	Pacer International Inc.
PACW	PacWest Bancorp
PAET	PAETEC Holding Corp.
PAGG	PowerShares Global Agriculture Portfolio
PANL	Universal Display Corporation
PARD	Poniard Pharmaceuticals Inc.
PARL	Parlux Fragrances Inc.
PATH	NuPathe Inc.
PATK	Patrick Industries Inc.
PATR	Patriot Transportation Holding Inc.
PAYX	Paychex Inc.
PBCT	People's United Financial Inc.
PBHC	Pathfinder Bancorp Inc.
PBIB	Porter Bancorp Inc.
PBIO	Pressure BioSciences Inc.
PBIP	Prudential Bancorp Inc. of Pennsylvania
PBNY	Provident New York Bancorp
PCAR	PACCAR Inc.
PCBC	Pacific Capital Bancorp
PCBK	Pacific Continental Corporation (Ore)
PCBS	Provident Community Bancshares Inc.
PCCC	PC Connection Inc.
PCH	Potlatch Corporation
PCLN	priceline.com Incorporated
PCOM	Points International Ltd.
PCRX	Pacira Pharmaceuticals Inc.
PCTI	PC-Tel Inc.
PCYC	Pharmacyclics Inc.
PCYO	Pure Cycle Corporation
PDCO	Patterson Companies Inc.
PDEX	Pro-Dex Inc.
PDFS	PDF Solutions Inc.
PDII	PDI Inc.
PDLI	PDL BioPharma Inc.
PDNT	Merrill Lynch & Co. Inc.
PEBK	Peoples Bancorp of North Carolina Inc.
PEBO	Peoples Bancorp Inc.
PEDH	Peoples Educational Holdings Inc.
PEET	Peet's Coffee & Tea Inc.
PEGA	Pegasystems Inc.
PEIX	Pacific Ethanol Inc.
PENN	Penn National Gaming Inc.
PENX	Penford Corporation
PEOP	Peoples Federal Bancshares Inc.
PERF	Perfumania Holdings Inc
PERY	Perry Ellis International Inc.
PESI	Perma-Fix Environmental Services Inc.
PETD	Petroleum Development Corporation
PETM	PetSmart Inc
PETS	PetMed Express Inc.
PFBC	Preferred Bank
PFBI	Premier Financial Bancorp Inc.
PFBX	Peoples Financial Corporation
PFCB	P.F.Chang's China Bistro Inc.
PFED	Park Bancorp Inc.
PFIN	P & F Industries Inc.
PFSW	PFSweb Inc.
PGC	Peapack-Gladstone Financial Corporation
PGEB	Merrill Lynch & Co. Inc.
PGNX	Progenics Pharmaceuticals Inc.
PGTI	PGT Inc.
PHII	PHI Inc.
PHIIK	PHI Inc.
PHMD	PhotoMedex Inc.
PICO	PICO Holdings Inc.
PKBK	Parke Bancorp Inc.
PKOH	Park-Ohio Holdings Corp.
PKOL	PowerShares Global Coal Portfolio
PLAB	Photronics Inc.
PLBC	Plumas Bancorp
PLCC	Paulson Capital Corp.
PLCE	The Children's Place Retail Stores Inc.
PLCM	Polycom Inc.
PLFE	Presidential Life Corporation
PLNR	Planar Systems Inc.
PLPC	Preformed Line Products Company
PLTM	First Trust Exchange-Traded Fund II First Trust ISE Global Platinum Index Fund
PLUG	Plug Power Inc.
PLUS	ePlus Inc.
PLXS	Plexus Corp.
PLXT	PLX Technology Inc.
PMBC	Pacific Mercantile Bancorp
PMCS	PMC - Sierra Inc.
PMD	Psychemedics Corporation
PMFG	PMFG Inc.
PMIC	Penn Millers Holding Corporation
PMNA	PowerShares MENA Frontier Countries Portfolio
PMTC	Parametric Technology Corporation
PMTI	Palomar Medical Technologies Inc.
PNBC	Princeton National Bancorp Inc.
PNBK	Patriot National Bancorp Inc.
PNCL	Pinnacle Airlines Corp.
PNFP	Pinnacle Financial Partners Inc.
PNNT	PennantPark Investment Corporation
PNNW	Pennichuck Corporation
PNQI	PowerShares NASDAQ Internet Portfolio
PNRA	Panera Bread Company
PNRG	PrimeEnergy Corporation
PNSN	Penson Worldwide Inc.
PNTR	Pointer Telocation Ltd.
PODD	Insulet Corporation
POOL	Pool Corporation
POPE	Pope Resources
POWI	Power Integrations Inc.
POWL	Powell Industries Inc.
POWR	PowerSecure International Inc
POZN	Pozen Inc.
PPBI	Pacific Premier Bancorp Inc
PPDI	Pharmaceutical Product Development Inc.
PPHM	Peregrine Pharmaceuticals Inc.
PRAA	Portfolio Recovery Associates Inc.
PRAN	Prana Biotechnology Ltd
PRCP	Perceptron Inc.
PRFT	Perficient Inc.
PRFZ	PowerShares FTSE RAFI US 1500 Small-Mid Portfolio
PRGO	Perrigo Company
PRGS	Progress Software Corporation
PRGX	PRGX Global Inc.
PRIM	Primoris Services Corporation
PRKR	ParkerVision Inc.
PRLS	Peerless Systems Corporation
PRMW	Primo Water Corporation
PROJ	Deltek Inc.
PROV	Provident Financial Holdings Inc.
PRPH	ProPhase Labs Inc.
PRSC	The Providence Service Corporation
PRSP	Prosperity Bancshares Inc.
PRST	Presstek Inc.
PRTS	U.S. Auto Parts Network Inc.
PRVT	Private Media Group Inc.
PRWT	Premier West Bancorp
PRWTD	Premier West Bancorp
PRXI	Premier Exhibitions Inc.
PRXL	PAREXEL International Corporation
PSAU	PowerShares Global Gold & Precious Metals Portfolio
PSBH	PSB Holdings Inc.
PSDV	pSivida Corp.
PSEC	Prospect Capital Corporation
PSEM	Pericom Semiconductor Corporation
PSID	PositiveID Corporation
PSMT	PriceSmart Inc.
PSOF	Pansoft Company Limited
PSSI	PSS World Medical Inc.
PSTB	Park Sterling Bank
PSTI	Pluristem Therapeutics Inc.
PSTL	PowerShares Global Steel Portfolio
PSTR	PostRock Energy Corporation
PSUN	Pacific Sunwear of California Inc.
PTEK	PokerTek Inc.
PTEKD	PokerTek Inc.
PTEN	Patterson-UTI Energy Inc.
PTIE	Pain Therapeutics
PTIX	Performance Technologies Incorporated
PTNR	Partner Communications Company Ltd.
PTRY	The Pantry Inc.
PTSI	P.A.M. Transportation Services Inc.
PTSX	Point.360
PULB	Pulaski Financial Corp.
PURE	PURE Bioscience
PVFC	PVF Capital Corp.
PVSA	Parkvale Financial Corporation
PVSW	Pervasive Software Inc.
PVTB	PrivateBancorp Inc.
PVTBP	PrivateBancorp Inc.
PWAV	Powerwave Technologies Inc.
PWER	Power-One Inc.
PWND	PowerShares Global Wind Energy Portfolio
PWOD	Penns Woods Bancorp Inc.
PWRD	Perfect World Co. Ltd.
PWX	Providence and Worcester Railroad Company
PXLW	Pixelworks Inc.
PZZA	Papa John's International Inc.
PZZI	Pizza Inn Inc.
QABA	First Trust NASDAQ ABA Community Bank Index Fund
QADA	QAD Inc.
QADB	QAD Inc.
QBAK	Qualstar Corporation
QCCO	QC Holdings Inc.
QCLN	First Trust NASDAQ Clean Edge U.S. Liquid Series Index Fund
QCOM	QUALCOMM Incorporated
QCOR	Questcor Pharmaceuticals Inc.
QCRH	QCR Holdings Inc.
QDEL	Quidel Corporation
QGEN	Qiagen N.V.
QKLS	QKL Stores Inc.
QLGC	QLogic Corporation
QLIK	Qlik Technologies Inc.
QLTI	QLT Inc.
QLTY	Quality Distribution Inc.
QNST	QuinStreet Inc.
QQEW	First Trust NASDAQ-100 Equal Weighted Index Fund
QQQQ	PowerShares QQQ Trust Series 1
QQQX	NASDAQ Premium Income and Growth Fund Inc.
QQXT	First Trust NASDAQ-100 Ex-Technology Sector Index Fund
QSFT	Quest Software Inc.
QSII	Quality Systems Inc.
QTEC	First Trust NASDAQ-100-Technology Sector Index Fund
QTWW	Quantum Fuel Systems Technologies Worldwide Inc.
QTWWD	Quantum Fuel Systems Technologies Worldwide Inc.
QUIK	QuickLogic Corporation
RADA	Rada Electronics Industries Limited
RADS	Radiant Systems Inc.
RAIL	FreightCar America Inc.
RAME	RAM Energy Resources Inc.
RAND	Rand Capital Corporation
RAVN	Raven Industries Inc.
RBCAA	Republic Bancorp Inc.
RBCN	Rubicon Technology Inc.
RBNF	Rurban Financial Corp
RBPAA	Royal Bancshares of Pennsylvania Inc.
RCII	Rent-A-Center Inc.
RCKB	Rockville Financial Inc.
RCKY	Rocky Brands Inc.
RCMT	RCM Technologies Inc.
RCON	Recon Technology Ltd.
RCRC	RC2 Corporation
RDA	RDA Microelectronics Inc.
RDCM	Radcom Ltd.
RDEA	Ardea Biosciences Inc.
RDEN	Elizabeth Arden Inc.
RDI	Reading International Inc
RDIB	Reading International Inc
RDNT	RadNet Inc.
RDWR	Radware Ltd.
RECN	Resources Connection Inc.
REDF	Rediff.com India Limited
REED	Reeds Inc.
REFR	Research Frontiers Incorporated
REGN	Regeneron Pharmaceuticals Inc.
REIS	Reis Inc
RELL	Richardson Electronics Ltd.
RELV	Reliv' International Inc.
RENT	Rentrak Corporation
REVU	The Princeton Review Inc.
REXI	Resource America Inc.
REXX	Rex Energy Corporation
RFIL	RF Industries Ltd.
RFMD	RF Micro Devices Inc.
RFMI	RF Monolithics Inc.
RGCO	RGC Resources Inc.
RGDX	Response Genetics Inc.
RGEN	Repligen Corporation
RGLD	Royal Gold Inc.
RGNC	Regency Energy Partners LP
RICK	Rick's Cabaret International Inc.
RIGL	Rigel Pharmaceuticals Inc.
RIMG	Rimage Corporation
RIMM	Research in Motion Limited
RITT	RIT Technologies Ltd.
RIVR	River Valley Bancorp.
RJET	Republic Airways Holdings Inc.
RLOC	ReachLocal Inc.
RLOG	Rand Logistics Inc.
RLRN	Renaissance Learning Inc.
RMBS	Rambus Inc.
RMCF	Rocky Mountain Chocolate Factory Inc.
RMKR	Rainmaker Systems Inc.
RMTI	Rockwell Medical Technologies Inc.
RMTR	Ramtron International Corporation
RNET	RigNet Inc.
RNIN	Wireless Ronin Technologies Inc.
RNOW	RightNow Technologies Inc.
RNST	Renasant Corporation
RNWK	RealNetworks Inc.
ROCK	Gibraltar Industries Inc.
ROCM	Rochester Medical Corporation
RODM	Rodman & Renshaw Capital Group Inc.
ROIA	Radio One Inc.
ROIAK	Radio One Inc.
ROIC	Retail Opportunity Investments Corp.
ROICU	Retail Opportunity Investments Corp.
ROICW	Retail Opportunity Investments Corp.
ROLL	RBC Bearings Incorporated
ROMA	Roma Financial Corporation
ROME	Rome Bancorp Inc.
ROSE	Rosetta Resources Inc.
ROSG	Rosetta Genomics Ltd.
ROST	Ross Stores Inc.
ROVI	Rovi Corporation
ROYL	Royale Energy Inc.
RP	RealPage Inc.
RPRX	Repros Therapeutics Inc.
RPTP	Raptor Pharmaceutical Corp.
RRD	R.R. Donnelley & Sons Company
RRGB	Red Robin Gourmet Burgers Inc.
RRST	RRSat Global Communications Network Ltd.
RSOL	Real Goods Solar Inc.
RSTI	Rofin-Sinar Technologies Inc.
RSYS	RadiSys Corporation
RTEC	Rudolph Technologies Inc.
RTIX	RTI Biologics Inc.
RTLX	Retalix Ltd.
RUE	rue21 inc.
RURL	Rural/Metro Corporation
RUSHA	Rush Enterprises Inc.
RUSHB	Rush Enterprises Inc.
RUTH	Ruth's Hospitality Group Inc.
RVBD	Riverbed Technology Inc.
RVSB	Riverview Bancorp Inc
RVSN	RADVision Ltd.
RXII	RXi Pharmaceuticals Corporation
RYAAY	Ryanair Holdings plc
SAAS	inContact Inc.
SABA	Saba Software Inc.
SAFM	Sanderson Farms Inc.
SAFT	Safety Insurance Group Inc.
SAIA	Saia Inc.
SALM	Salem Communications Corporation
SANM	Sanmina-SCI Corporation
SANW	S&W Seed Company
SANWW	S&W Seed Company
SANWZ	S&W Seed Company
SAPE	Sapient Corporation
SAPX	Seven Arts Pictures PLC
SASR	Sandy Spring Bancorp Inc.
SATC	SatCon Technology Corporation
SATS	EchoStar Corporation
SAVB	The Savannah Bancorp Inc.
SBAC	SBA Communications Corporation
SBAY	Subaye Inc.
SBBX	Sussex Bancorp
SBCF	Seacoast Banking Corporation of Florida
SBGI	Sinclair Broadcast Group Inc.
SBIB	Sterling Bancshares Inc.
SBIBN	Sterling Bancshares Inc.
SBIBW	Sterling Bancshares Inc.
SBLK	Star Bulk Carriers Corp.
SBNY	Signature Bank
SBNYW	Signature Bank
SBRA	Sabra Healthcare REIT Inc.
SBSA	Spanish Broadcasting System Inc.
SBSI	Southside Bancshares Inc.
SBUX	Starbucks Corporation
SCBT	SCBT Financial Corporation
SCEI	Sino Clean Energy Inc.
SCHL	Scholastic Corporation
SCHN	Schnitzer Steel Industries Inc.
SCHS	School Specialty Inc.
SCIL	Scientific Learning Corporation
SCKT	Socket Mobile Inc.
SCLN	SciClone Pharmaceuticals Inc.
SCMF	Southern Community Financial Corporation
SCMFO	Southern Community Financial Corporation
SCMP	Sucampo Pharmaceuticals Inc.
SCMR	Sycamore Networks Inc.
SCOK	SinoCoking Coal and Coke Chemical Industries Inc
SCON	Superconductor Technologies Inc.
SCOR	comScore Inc.
SCSC	ScanSource Inc.
SCSS	Select Comfort Corporation
SCVL	Shoe Carnival Inc.
SDBT	SoundBite Communications Inc.
SDIX	Strategic Diagnostics Inc.
SDTH	ShengdaTech Inc.
SEAC	SeaChange International Inc.
SEED	Origin Agritech Limited
SEIC	SEI Investments Company
SENEA	Seneca Foods Corp.
SENEB	Seneca Foods Corp.
SERV	Servidyne Inc.
SFLY	Shutterfly Inc.
SFNC	Simmons First National Corporation
SFSF	SuccessFactors Inc.
SFST	Southern First Bancshares Inc.
SGC	Superior Uniform Group Inc.
SGEN	Seattle Genetics Inc.
SGI	Silicon Graphics International Corp
SGMA	SigmaTron International Inc.
SGMO	Sangamo BioSciences Inc.
SGMS	Scientific Games Corp
SGOC	SGOCO Group Ltd
SGRP	SPAR Group Inc.
SHBI	Shore Bancshares Inc
SHEN	Shenandoah Telecommunications Co
SHFL	Shuffle Master Inc.
SHIP	Seanergy Maritime Holdings Corp
SHIPW	Seanergy Maritime Holdings Corp
SHLD	Sears Holdings Corporation
SHLM	A. Schulman Inc.
SHLO	Shiloh Industries Inc.
SHMR	Shamir Optical Industry Ltd.
SHOO	Steven Madden Ltd.
SHOR	ShoreTel Inc.
SHPGY	Shire plc
SIAL	Sigma-Aldrich Corporation
SIEB	Siebert Financial Corp.
SIFI	SI Financial Group Inc.
SIFID	SI Financial Group Inc.
SIFY	Sify Technologies Limited
SIGA	SIGA Technologies Inc.
SIGI	Selective Insurance Group Inc.
SIGM	Sigma Designs Inc.
SILC	Silicom Ltd
SIMG	Silicon Image Inc.
SIMO	Silicon Motion Technology Corporation
SINA	Sina Corporation
SINO	Sino-Global Shipping America Ltd.
SIRI	Sirius XM Radio Inc.
SIRO	Sirona Dental Systems Inc.
SIVB	SVB Financial Group
SIVBO	SVB Financial Group
SKBI	Skystar Bio-Pharmaceutical Company
SKYW	SkyWest Inc.
SLAB	Silicon Laboratories Inc.
SLGN	Silgan Holdings Inc.
SLP	Simulations Plus Inc.
SLRC	Solar Capital Ltd.
SLTC	Selectica Inc.
SLTM	Solta Medical Inc
SLXP	Salix Pharmaceuticals Ltd.
SMBC	Southern Missouri Bancorp Inc.
SMBL	Smart Balance Inc
SMCG	Millenium India Acquisition Company Inc.
SMCI	Super Micro Computer Inc.
SMED	Sharps Compliance Corp
SMHG	Sanders Morris Harris Group Inc.
SMIT	Schmitt Industries Inc.
SMMF	Summit Financial Group Inc.
SMOD	SMART Modular Technologies (WWH) Inc.
SMRT	Stein Mart Inc.
SMSC	Standard Microsystems Corporation
SMSI	Smith Micro Software Inc.
SMT	SMART Technologies Inc.
SMTC	Semtech Corporation
SMTX	SMTC Corporation
SNAK	Inventure Foods Inc.
SNBC	Sun Bancorp Inc.
SNCR	Synchronoss Technologies Inc.
SNDA	Shanda Interactive Entertainment Limited
SNDK	SanDisk Corporation
SNFCA	Security National Financial Corporation
SNHY	Sun Hydraulics Corporation
SNIC	Sonic Solutions
SNMX	Senomyx Inc.
SNPS	Synopsys Inc.
SNSS	Sunesis Pharmaceuticals Inc.
SNSSD	Sunesis Pharmaceuticals Inc.
SNSTA	Sonesta International Hotels Corporation
SNTA	Synta Pharmaceuticals Corp.
SNTS	Santarus Inc.
SOCB	Southcoast Financial Corporation
SODA	SodaStream International Ltd.
SOFO	Sonic Foundry Inc.
SOHU	Sohu.com Inc.
SOLF	Solarfun Power Holdings Co. Ltd.
SOLR	GT Solar International Inc.
SOMH	Somerset Hills Bancorp
SOMX	Somaxon Pharmaceuticals Inc.
SONA	Southern National Bancorp of Virginia Inc.
SONC	Sonic Corp.
SONE	S1 Corporation
SONO	SonoSite Inc.
SONS	Sonus Networks Inc.
SORL	SORL Auto Parts Inc.
SOXX	iShares PHLX SOX Semiconductor Sector Index Fund
SPAN	Span-America Medical Systems Inc.
SPAR	Spartan Motors Inc.
SPBC	SP Bancorp Inc.
SPCHA	Sport Chalet Inc.
SPCHB	Sport Chalet Inc.
SPEC	Spectrum Control Inc.
SPEX	Spherix Incorporated
SPIL	Siliconware Precision Industries Company Ltd.
SPIR	Spire Corporation
SPLS	Staples Inc.
SPMD	SuperMedia Inc.
SPNC	The Spectranetics Corporation
SPNS	Sapiens International Corporation N.V.
SPPI	Spectrum Pharmaceuticals Inc.
SPPR	Supertel Hospitality Inc.
SPPRO	Supertel Hospitality Inc.
SPPRP	Supertel Hospitality Inc.
SPRD	Spreadtrum Communications Inc.
SPRO	SmartPros Ltd.
SPRT	support.com Inc.
SPSC	SPS Commerce Inc.
SPTN	Spartan Stores Inc.
SPU	SkyPeople Fruit Juice Inc.
SPWRA	SunPower Corporation
SPWRB	SunPower Corporation
SQI	SciQuest Inc.
SQNM	Sequenom Inc.
SQQQ	ProShares UltraPro Short QQQ
SRCE	1st Source Corporation
SRCL	Stericycle Inc.
SRDX	SurModics Inc.
SRIB	Merrill Lynch & Co. Inc.
SRLS	SeraCare Life Sciences Inc
SRSL	SRS Labs Inc.
SSBI	Summit State Bank
SSFN	Stewardship Financial Corp
SSNC	SS&C Technologies Holdings Inc.
SSRI	Silver Standard Resources Inc
SSRX	3SBio Inc.
SSYS	Stratasys Inc.
STAA	STAAR Surgical Company
STAN	Standard Parking Corporation
STBA	S&T Bancorp Inc.
STBC	State Bancorp Inc.
STEC	STEC Inc.
STEI	Stewart Enterprises Inc.
STEL	StellarOne Corporation
STEM	StemCells Inc.
STFC	State Auto Financial Corporation
STKL	SunOpta Inc.
STLD	Steel Dynamics Inc.
STLY	Stanley Furniture Company Inc.
STMP	Stamps.com Inc.
STND	Standard Financial Corp.
STNR	Steiner Leisure Limited
STON	StoneMor Partners L.P.
STRA	Strayer Education Inc.
STRC	SRI/Surgical Express Inc.
STRL	Sterling Construction Company Inc
STRM	Streamline Health Solutions Inc.
STRN	Sutron Corporation
STRS	Stratus Properties Inc.
STRT	Strattec Security Corporation
STRZ	Star Buffet Inc.
STSA	Sterling Financial Corporation
STX	Seagate Technology.
STXS	Stereotaxis Inc.
SUBC	Subsea 7 SA
SUBK	Suffolk Bancorp
SUMR	Summer Infant Inc.
SUNH	Sun Healthcare Group Inc.
SUPG	SuperGen Inc.
SUPR	Superior Bancorp
SUPX	Supertex Inc.
SURG	Synergetics USA Inc.
SURW	SureWest Communications
SUSQ	Susquehanna Bancshares Inc.
SUSS	Susser Holdings Corporation
SUTR	Sutor Technology Group Limited
SVA	Sinovac Biotech Ltd.
SVBI	Severn Bancorp Inc
SVLF	Silverleaf Resorts Inc.
SVNT	Savient Pharmaceuticals Inc
SVVS	SAVVIS Inc.
SWHC	Smith & Wesson Holding Corporation
SWIR	Sierra Wireless Inc.
SWKS	Skyworks Solutions Inc.
SWSH	Swisher Hygiene Inc.
SXCI	SXC Health Solutions Corp.
SYBT	S.Y. Bancorp Inc.
SYBTP	S.Y. Bancorp Inc.
SYKE	Sykes Enterprises Incorporated
SYMC	Symantec Corporation
SYMM	Symmetricom Inc.
SYMS	Syms Corp
SYMX	Synthesis Energy Systems Inc.
SYNA	Synaptics Incorporated
SYNL	Synalloy Corporation
SYNM	Syntroleum Corporation
SYNO	Synovis Life Technologies Inc.
SYNT	Syntel Inc.
SYPR	Sypris Solutions Inc.
SYUT	Synutra International Inc.
TACT	TransAct Technologies Incorporated
TAIT	Taitron Components Incorporated
TASR	TASER International Inc.
TAST	Carrols Restaurant Group Inc.
TATT	TAT Technologies Ltd.
TAXI	Medallion Financial Corp.
TAYC	Taylor Capital Group Inc.
TAYCP	Taylor Capital Group Inc.
TAYD	Taylor Devices Inc.
TBAC	Tandy Brands Accessories Inc.
TBBK	The Bancorp Inc.
TBET	Tibet Pharmaceuticals Inc.
TBNK	Territorial Bancorp Inc.
TBOW	Trunkbow International Holdings Ltd.
TBSI	TBS International Plc
TBUS	DRI Corporation
TCBI	Texas Capital Bancshares Inc.
TCBIW	Texas Capital Bancshares Inc.
TCBK	TriCo Bancshares
TCCO	Technical Communications Corporation
TCHC	21st Century Holding Company
TCLP	TC PipeLines LP
TCRD	THL Credit Inc.
TDBK	Tidelands Bancshares Inc.
TDSC	3D Systems Corporation
TEAR	TearLab Corporation
TECD	Tech Data Corporation
TECH	Techne Corporation
TECUA	Tecumseh Products Company
TECUB	Tecumseh Products Company
TELK	Telik Inc.
TESO	Tesco Corporation
TESS	TESSCO Technologies Incorporated
TEVA	Teva Pharmaceutical Industries Limited
TFCO	Tufco Technologies Inc.
TFM	The Fresh Market Inc.
TFONY	Telefonos de Mexico
TFSL	TFS Financial Corporation
TGA	Transglobe Energy Corp
TGAL	Tegal Corporation
TGE	TGC Industries Inc.
TGIS	Thomas Group Inc.
THFF	First Financial Corporation Indiana
THLD	Threshold Pharmaceuticals Inc.
THOR	Thoratec Corporation
THQI	THQ Inc.
THRD	TF Financial Corporation
THRX	Theravance Inc.
THTI	THT Heat Transfer Technology Inc.
TIBB	TIB Financial Corporation
TIBX	TIBCO Software Inc.
TICC	TICC Capital Corp.
TIER	Tier Technologies Inc.
TIGR	TigerLogic Corporation
TIII	TII Network Technologies Inc.
TINY	Harris & Harris Group Inc.
TISA	Top Image Systems Ltd.
TISI	Team Inc.
TITN	Titan Machinery Inc.
TIVO	TiVo Inc.
TKLC	Tekelec
TKMR	Tekmira Pharmaceuticals Corp
TLAB	Tellabs Inc.
TLCR	Talecris Biotherapeutics Holdings Corp.
TLEO	Taleo Corporation
TLF	Tandy Leather Factory Inc.
TLGD	Tollgrade Communications Inc.
TLVT	Telvent GIT S.A.
TMNG	The Management Network Group Inc.
TMRK	Terremark Worldwide Inc.
TNAV	TeleNav Inc.
TNCC	Tennessee Commerce Bancorp Inc. (TN)
TNDM	Neutral Tandem Inc.
TNGN	Tengion Inc.
TO	Tech/Ops Sevcon Inc.
TOBC	Tower Bancorp Inc
TOFC	Tower Financial Corporation
TOMO	TomoTherapy Incorporated
TOPS	TOP Ships Inc.
TORM	TOR Minerals International Inc
TOWN	Towne Bank
TPCG	TPC Group Inc.
TPGI	Thomas Properties Group Inc.
TQNT	TriQuint Semiconductor Inc.
TQQQ	ProShares UltraPro QQQ
TRAD	TradeStation Group Inc
TRAK	DealerTrack Holdings Inc.
TRBR	Trailer Bridge Inc.
TRCI	Technology Research Corporation
TRCR	Transcend Services Inc.
TREE	Tree.com Inc.
TRGL	Toreador Resources Corporation
TRGT	Targacept Inc.
TRIB	Trinity Biotech plc
TRID	Trident Microsystems Inc.
TRIT	Tri-Tech Holding Inc.
TRLG	True Religion Apparel Inc.
TRMB	Trimble Navigation Limited
TRMD	TORM A/S
TRMK	Trustmark Corporation
TRMS	Trimeris Inc.
TRNS	Transcat Inc.
TRNX	Tornier N.V.
TROW	T. Rowe Price Group Inc.
TRS	TriMas Corporation
TRST	TrustCo Bank Corp NY
TRUE	Centrue Financial Corporation
TSBK	Timberland Bancorp Inc.
TSCO	Tractor Supply Company
TSEM	Tower Semiconductor Ltd.
TSEMG	Tower Semiconductor Ltd.
TSLA	Tesla Motors Inc.
TSON	TranS1 Inc.
TSPT	Transcept Pharmaceuticals Inc.
TSRA	Tessera Technologies Inc.
TSRI	TSR Inc.
TSRX	Trius Therapeutics Inc.
TST	TheStreet.com Inc.
TSTC	Telestone Technologies Corp.
TSTF	TeamStaff Inc.
TSTY	Tasty Baking Company
TSYS	TeleCommunication Systems Inc.
TTEC	TeleTech Holdings Inc.
TTEK	Tetra Tech Inc.
TTGT	TechTarget Inc.
TTHI	Transition Therapeutics Inc.
TTMI	TTM Technologies Inc.
TTWO	Take-Two Interactive Software Inc.
TUES	Tuesday Morning Corp.
TWER	Towerstream Corporation
TWGP	Tower Group Inc.
TWIN	Twin Disc Incorporated
TWMC	Trans World Entertainment Corp.
TWTC	tw telecom inc.
TXCC	TranSwitch Corporation
TXRH	Texas Roadhouse Inc.
TYPE	Monotype Imaging Holdings Inc.
TZOO	Travelzoo Inc
UACL	Universal Truckload Services Inc.
UBCP	United Bancorp Inc.
UBFO	United Security Bancshares
UBNK	United Financial Bancorp Inc.
UBOH	United Bancshares Inc.
UBSH	Union First Market Bankshares Corporation
UBSI	United Bankshares Inc.
UCBA	United Community Bancorp
UCBI	United Community Banks Inc.
UCFC	United Community Financial Corp.
UCTT	Ultra Clean Holdings Inc.
UDRL	Union Drilling Inc.
UEIC	Universal Electronics Inc.
UEPS	Net 1 UEPS Technologies Inc.
UFCS	United Fire & Casualty Company
UFPI	Universal Forest Products Inc.
UFPT	UFP Technologies Inc.
UG	United-Guardian Inc.
UHAL	Amerco
ULBI	Ultralife Corporation
ULGX	Urologix Inc.
ULTA	Ulta Salon Cosmetics & Fragrance Inc.
ULTI	The Ultimate Software Group Inc.
ULTR	Ultrapetrol (Bahamas) Limited
UMBF	UMB Financial Corporation
UMPQ	Umpqua Holdings Corporation
UNAM	Unico American Corporation
UNB	Union Bankshares Inc.
UNFI	United Natural Foods Inc.
UNFY	Unify Corporation
UNIS	Unilife Corporation
UNTD	United Online Inc.
UNTK	UniTek Global Services Inc.
UNTY	Unity Bancorp Inc.
UNXL	Uni-Pixel Inc.
UPI	Uroplasty Inc.
URBN	Urban Outfitters Inc.
URRE	Uranium Resources Inc.
USAK	USA Truck Inc.
USAP	Universal Stainless & Alloy Products Inc.
USAT	USA Technologies Inc.
USATP	USA Technologies Inc.
USATW	USA Technologies Inc.
USATZ	USA Technologies Inc.
USBI	United Security Bancshares Inc.
USCR	U S Concrete Inc.
USEG	U.S. Energy Corp.
USHS	U.S. Home Systems Inc.
USLM	United States Lime & Minerals Inc.
USMO	USA Mobility Inc.
USPH	U.S. Physical Therapy Inc.
USTR	United Stationers Inc.
UTEK	Ultratech Inc.
UTHR	United Therapeutics Corporation
UTIW	UTi Worldwide Inc.
UTMD	Utah Medical Products Inc.
UTSI	UTStarcom Inc.
UVSP	Univest Corporation of Pennsylvania
VALU	Value Line Inc.
VALV	Shengkai Innovations Inc.
VASC	Vascular Solutions Inc.
VBFC	Village Bank and Trust Financial Corp.
VCBI	Virginia Commerce Bancorp
VCGH	VCG Holding Corporation
VCIT	Vanguard Intermediate-Term Corporate Bond ETF
VCLK	ValueClick Inc.
VCLT	Vanguard Long-Term Corporate Bond ETF
VCSH	Vanguard Short-Term Corporate Bond ETF
VDSI	VASCO Data Security International Inc.
VECO	Veeco Instruments Inc.
VELT	Velti plc
VGIT	Vanguard Intermediate -Term Government Bond ETF
VGLT	Vanguard Long-Term Government Bond ETF
VGSH	Vanguard Short Term Government Bond ETF
VIAS	Viasystems Group Inc.
VICL	Vical Incorporated
VICR	Vicor Corporation
VIDE	Video Display Corporation
VIFL	Food Technology Service Inc.
VIMC	Vimicro International Corporation
VIRC	Virco Manufacturing Corporation
VISN	VisionChina Media Inc.
VIST	VIST Financial Corp
VITA	Orthovita Inc.
VIVO	Meridian Bioscience Inc.
VLCCF	Knightsbridge Tankers Limited
VLCM	Volcom Inc.
VLGEA	Village Super Market Inc.
VLNC	Valence Technology Inc.
VLTR	Volterra Semiconductor Corporation
VLYWW	Valley National Bancorp
VMBS	Vanguard Mortgage-Backed Securities ETF
VMED	Virgin Media Inc.
VNDA	Vanda Pharmaceuticals Inc.
VNQI	Vanguard International Equity Index Funds Vanguard Global ex-U.S. Real Estate ETF
VOCS	Vocus Inc.
VOD	Vodafone Group Plc
VOLC	Volcano Corporation
VOLT	Voltaire Ltd.
VONE	Vanguard Scottsdale Funds Vanguard Russell 1000 ETF
VONG	Vanguard Scottsdale Funds Vanguard Russell 1000 Growth ETF
VONV	Vanguard Scottsdale Funds Vanguard Russell 1000 Value ETF
VOXX	Audiovox Corporation
VPF	Valpey Fisher Corporation
VPFG	ViewPoint Financial Group Inc.
VPHM	ViroPharma Incorporated
VPRT	Vistaprint N.V.
VRA	Vera Bradley Inc.
VRGY	Verigy Ltd.
VRML	Vermillion Inc.
VRNM	Verenium Corporation
VRNT	Verint Systems Inc.
VRSK	Verisk Analytics Inc.
VRSN	VeriSign Inc.
VRTA	Vestin Realty Mortgage I Inc.
VRTB	Vestin Realty Mortgage II Inc.
VRTS	Virtus Investment Partners Inc.
VRTU	Virtusa Corporation
VRTX	Vertex Pharmaceuticals Incorporated
VRUS	Pharmasset Inc.
VSAT	ViaSat Inc.
VSBN	VSB Bancorp Inc. (NY)
VSCI	Vision-Sciences Inc.
VSCP	VirtualScopics Inc.
VSEA	Varian Semiconductor Equipment Associates Inc.
VSEC	VSE Corporation
VSNT	Versant Corporation
VTAL	Vital Images Inc.
VTHR	Vanguard Scottsdale Funds Vanguard Russell 3000 ETF
VTNC	Vitran Corporation Inc.
VTRO	Vertro Inc
VTSS	Vitesse Semiconductor Corporation
VTUS	Ventrus Biosciences Inc.
VTWG	Vanguard Scottsdale Funds Vanguard Russell 2000 Growth ETF
VTWO	Vanguard Scottsdale Funds Vanguard Russell 2000 ETF
VTWV	Vanguard Scottsdale Funds Vanguard Russell 2000 Value ETF
VVTV	ValueVision Media Inc.
VVUS	Vivus Inc.
VXUS	Vanguard STAR Funds Vanguard Total International Stock ETF
VYFC	Valley Financial Corporation
WABC	Westamerica Bancorporation
WACLY	Wacoal Holdings Corporation
WASH	Washington Trust Bancorp Inc.
WATG	Wonder Auto Technology Inc.
WAVX	Wave Systems Corp.
WAYN	Wayne Savings Bancshares Inc.
WBCO	Washington Banking Company
WBKC	Wolverine Bancorp Inc.
WBMD	WebMD Health Corp
WBNK	Waccamaw Bankshares Inc
WBNKW	Waccamaw Bankshares Inc
WBSN	Websense Inc.
WBSTP	Webster Preferred Capital Corp
WCAA	WCA Waste Corporation
WCBO	West Coast Bancorp
WCRX	Warner Chilcott plc
WDFC	WD-40 Company
WEBM	WebMediaBrands Inc
WERN	Werner Enterprises Inc.
WEST	Akeena Solar Inc. d/b/a Westinghouse Solar
WEYS	Weyco Group Inc.
WFD	Westfield Financial Inc.
WFMI	Whole Foods Market Inc.
WFSL	Washington Federal Inc.
WFSLW	Washington Federal Inc.
WHRT	World Heart Corporation
WIBC	Wilshire Bancorp Inc.
WILC	G. Willi-Food International  Ltd.
WIN	Windstream Corporation
WINA	Winmark Corporation
WINN	Winn-Dixie Stores Inc.
WIRE	Encore Wire Corporation
WLBC	Western Liberty Bancorp
WLDN	Willdan Group Inc.
WLFC	Willis Lease Finance Corporation
WLFCP	Willis Lease Finance Corporation
WMAR	West Marine Inc.
WMCO	Williams Controls Inc.
WMGI	Wright Medical Group Inc.
WOLF	Great Wolf Resorts Inc.
WOOD	iShares S&P Global Timber &Forestry Index Fund
WOOF	VCA Antech Inc.
WPCS	WPCS International Incorporated
WPPGY	WPP plc
WPRT	Westport Innovations Inc
WRES	Warren Resources Inc.
WRLD	World Acceptance Corporation
WRLS	Telular Corporation
WSB	WSB Holdings Inc.
WSBC	WesBanco Inc.
WSBF	Waterstone Financial Inc.
WSCI	WSI Industries Inc.
WSFS	WSFS Financial Corporation
WSTG	Wayside Technology Group Inc.
WSTL	Westell Technologies Inc.
WTBA	West Bancorporation
WTFC	Wintrust Financial Corporation
WTFCW	Wintrust Financial Corporation
WTNY	Whitney Holding Corporation
WTSLA	The Wet Seal Inc.
WUHN	Wuhan General Group (China) Inc.
WVFC	WVS Financial Corp.
WVVI	Willamette Valley Vineyards Inc.
WWAY	Westway Group Inc.
WWAYU	Westway Group Inc.
WWAYW	Westway Group Inc.
WWD	Woodward Inc.
WWIN	Winner Medical Group Inc.
WWON	Westwood One Inc.
WWVY	Warwick Valley Telephone Company
WWWW	Web.com Group Inc
WYNN	Wynn Resorts Limited
XATA	XATA Corporation
XBKS	Xenith Bankshares Inc.
XETA	XETA Technologies Inc.
XIDE	Exide Technologies
XIDEW	Exide Technologies
XING	Qiao Xing Universal Resources Inc.
XLBS	PowerShares Exchange-Traded Fund Trust II PowerShares S&P SmallCap Materials Portfolio
XLES	PowerShares Exchange-Traded Fund Trust II PowerShares S&P SmallCap Energy Portfolio
XLFS	PowerShares Exchange-Traded Fund Trust II PowerShares S&P SmallCap Financials Portfolio
XLIS	PowerShares Exchange-Traded Fund Trust II PowerShares S&P SmallCap Industrials Portfolio
XLKS	PowerShares Exchange-Traded Fund Trust II PowerShares S&P SmallCap Information Technology Portfolio
XLNX	Xilinx Inc.
XLPS	PowerShares Exchange-Traded Fund Trust II PowerShares S&P SmallCap Consumer Staples Portfolio
XLUS	PowerShares Exchange-Traded Fund Trust II PowerShares S&P SmallCap Utilities Portfolio
XLVS	PowerShares Exchange-Traded Fund Trust II PowerShares S&P SmallCap Health Care Portfolio
XLYS	PowerShares Exchange-Traded Fund Trust II PowerShares S&P SmallCap Consumer Discretionary Portfolio
XNPT	XenoPort Inc.
XOMA	XOMA Ltd.
XPRT	LECG Corporation
XRAY	DENTSPLY International Inc.
XRIT	X-Rite Incorporated
XRTX	Xyratex Ltd.
XSEL	Xinhua Sports & Entertainment Limited
XSELD	Xinhua Sports & Entertainment Limited
XTEX	Crosstex Energy L.P.
XTXI	Crosstex Energy Inc.
XWES	World Energy Solutions Inc (DE)
XXIA	Ixia
YAVY	Yadkin Valley Financial Corporation
YDNT	Young Innovations Inc.
YHOO	Yahoo! Inc.
YONG	Yongye International Inc.
YORW	The York Water Company
YRCW	YRC Worldwide Inc.
YTEC	Yucheng Technologies Limited
YUII	Yuhe International Inc
ZAGG	ZAGG Incorporated
ZANE	Zanett Inc.
ZBRA	Zebra Technologies Corporation
ZEUS	Olympic Steel Inc.
ZGNX	Zogenix Inc.
ZHNE	Zhone Technologies Inc.
ZIGO	Zygo Corporation
ZINC	Horsehead Holding Corp.
ZION	Zions Bancorporation
ZIONW	Zions Bancorporation
ZIOP	ZIOPHARM Oncology Inc
ZIPR	ZipRealty Inc.
ZIXI	Zix Corporation
ZLCS	Zalicus Inc.
ZN	Zion Oil & Gas Inc
ZNWAW	Zion Oil & Gas Inc
ZOLL	Zoll Medical Corporation
ZOLT	Zoltek Companies Inc.
ZOOG	Zoo Entertainment Inc.
ZOOM	Zoom Technologies Inc.
ZRAN	Zoran Corporation
ZSTN	ZST Digital Networks Inc.
ZUMZ	Zumiez Inc.
